Bilderbuchabsturz	Bilderbuch	Absturz
Bilderbuchabteilung	Bilderbuch	Abteilung
Bilderbuchadaption	Bilderbuch	Adaption
Bilderbuchalter	Bilderbuch	Alter
Bilderbuch-Altstadt	Bilderbuch	Altstadt
Bilderbuch-Amerikaner	Bilderbuch	Amerikaner
Bilderbuchangriff	Bilderbuch	Angriff
Bilderbuchanschauer	Bilderbuch	Anschauer
Bilderbuch-Anwesen	Bilderbuch	Anwesen
Bilderbuchaufenthalt	Bilderbuch	Aufenthalt
Bilderbuchauflage	Bilderbuch	Auflage
Bilderbuchauftakt	Bilderbuch	Auftakt
Bilderbuch-Ausleihe	Bilderbuch	Ausleihe
Bilderbuchauslese	Bilderbuch	Auslese
Bilderbuch-Ausstellung	Bilderbuch	Ausstellung
Bilderbuchauswahl	Bilderbuch	Auswahl
Bilderbuchautorin	Bilderbuch	Autorin
Bilderbuchbabe	Bilderbuch	Babe
Bilderbuchband	Bilderbuch	Band
Bilderbuch-Bär	Bilderbuch	Bär
Bilderbuch-Bauchladentheater	Bilderbuch	Bauchladentheater
Bilderbuchbauer	Bilderbuch	Bauer
Bilderbuch-Bayern	Bilderbuch	Bayern
Bilderbuchbereich	Bilderbuch	Bereich
Bilderbuchbestand	Bilderbuch	Bestand
Bilderbuch-Bestseller	Bilderbuch	Bestseller
Bilderbuchbetrachtung	Bilderbuch	Betrachtung
Bilderbuchbetrieb	Bilderbuch	Betrieb
Bilderbuchbibliothek	Bilderbuch	Bibliothek
Bilderbuchbiographie	Bilderbuch	Biographie
Bilderbuchblatt	Bilderbuch	Blatt
Bilderbuch-Blitzstart	Bilderbuch	Blitzstart
Bilderbuchblonde	Bilderbuch	Blonde
Bilderbuch-Blondine	Bilderbuch	Blondine
Bilderbuch-Blüte	Bilderbuch	Blüte
Bilderbuch-Bohème	Bilderbuch	Bohème
Bilderbuchbonze	Bilderbuch	Bonze
Bilderbuchbörse	Bilderbuch	Börse
Bilderbuch-Bürger	Bilderbuch	Bürger
Bilderbuchburg	Bilderbuch	Burg
Bilderbuchbutler	Bilderbuch	Butler
Bilderbuch-Chaletdorf	Bilderbuch	Chaletdorf
Bilderbuch-Countdown	Bilderbuch	Countdown
Bilderbuchdasein	Bilderbuch	Dasein
Bilderbuchdebüt	Bilderbuch	Debüt
Bilderbuchdirigenten	Bilderbuch	Dirigent
Bilderbuchdorf	Bilderbuch	Dorf
Bilderbuchdüne	Bilderbuch	Düne
Bilderbuchecke	Bilderbuch	Ecke
Bilderbuch-Edelmut	Bilderbuch	Edelmut
Bilderbuch-Effekt	Bilderbuch	Effekt
Bilderbuch-Ehefrau	Bilderbuch	Ehefrau
Bilderbuch-Ehepartner	Bilderbuch	Ehepartner
Bilderbuch-Einstand	Bilderbuch	Einstand
Bilderbuch-Engländer	Bilderbuch	Engländer
Bilderbuchepisode	Bilderbuch	Episode
Bilderbucherarbeitung	Bilderbuch	Erarbeitung
Bilderbuch-Erfolgsstory	Bilderbuch	Erfolgsstory
Bilderbuchergebnis	Bilderbuch	Ergebnis
Bilderbuch-Erzählung	Bilderbuch	Erzählung
Bilderbuch-Eskalation	Bilderbuch	Eskalation
Bilderbuchfamilie	Bilderbuch	Familie
Bilderbuch-Familienvater	Bilderbuch	Familienvater
Bilderbuch-Farmer	Bilderbuch	Farmer
Bilderbuchfassung	Bilderbuch	fassung
Bilderbuchfjord	Bilderbuch	Fjord
Bilderbuch-Flugwetter	Bilderbuch	Flugwetter
Bilderbuchforschung	Bilderbuch	Forschung
Bilderbuch-Fuß	Bilderbuch	Fuß
Bilderbuchgangster	Bilderbuch	Gangster
Bilderbuchganove	Bilderbuch	Ganove
Bilderbuchgeburt	Bilderbuch	Geburt
Bilderbuch-Genuß	Bilderbuch	Genuss
Bilderbuch-Geschichte	Bilderbuch	Geschichte
Bilderbuch-Gestaltung	Bilderbuch	Gestaltung
Bilderbuchgrafik	Bilderbuch	Grafik
Bilderbuch-Großformat	Bilderbuch	Großformat
Bilderbuchgrundstück	Bilderbuch	Grundstück
Bilderbuch-Hafen	Bilderbuch	Hafen
Bilderbuchhäftling	Bilderbuch	Häftling
Bilderbuchhalbmond	Bilderbuch	Halbmond
Bilderbuchhändler	Bilderbuch	Händler
Bilderbuchharmonie	Bilderbuch	Harmonie
Bilderbuchheldin	Bilderbuch	Heldin
Bilderbuchhersteller	Bilderbuch	Hersteller
Bilderbuch-Hessentag	Bilderbuch	Hessentag
Bilderbuchhochzeit	Bilderbuch	Hochzeit
Bilderbuchidyll	Bilderbuch	Idyll
Bilderbuchillustration	Bilderbuch	Illustration
Bilderbuch-Immobilie	Bilderbuch	Immobilie
Bilderbuchinszenierung	Bilderbuch	inszenierung
Bilderbuchintegration	Bilderbuch	Integration
Bilderbuch-Intellektueller	Bilderbuch	Intellektueller
Bilderbuchjahrgang	Bilderbuch	Jahrgang
Bilderbuch-Japaner	Bilderbuch	Japaner
Bilderbuch-Kabinett	Bilderbuch	Kabinett
Bilderbuchkarriere	Bilderbuch	Karriere
Bilderbuchkegel	Bilderbuch	Kegel
Bilderbuchkindheit	Bilderbuch	Kindheit
Bilderbuch-Kleinstadt	Bilderbuch	Kleinstadt
Bilderbuchklima	Bilderbuch	Klima
Bilderbuch-Klinik	Bilderbuch	Klinik
Bilderbuch-Kollektion	Bilderbuch	Kollektion
Bilderbuch-Konter	Bilderbuch	Konter
Bilderbuchkritik	Bilderbuch	Kritik
Bilderbuch-Kugeltragen	Bilderbuch	Kugeltragen
Bilderbuchkulisse	Bilderbuch	Kulisse
Bilderbuch-Kulturbonze	Bilderbuch	Kulturbonze
Bilderbuchkunst	Bilderbuch	Kunst
Bilderbuch-Künstler	Bilderbuch	Künstler
Bilderbuch-Kuschelecke	Bilderbuch	Kuschelecke
Bilderbuchküste	Bilderbuch	Küste
Bilderbuchlandschaft	Bilderbuch	Landschaft
Bilderbuchlandung	Bilderbuch	Landung
Bilderbuchlaufbahn	Bilderbuch	Laufbahn
Bilderbuchlauf	Bilderbuch	Lauf
Bilderbuchlektüre	Bilderbuch	Lektüre
Bilderbuchlesen	Bilderbuch	Lesen
Bilderbuchleser	Bilderbuch	Leser
Bilderbuch-Lesung	Bilderbuch	Lesung
Bilderbuch-Licht	Bilderbuch	Licht
Bilderbuchmacho	Bilderbuch	Macho
Bilderbuchmädchen	Bilderbuch	Mädchen
Bilderbuchmafiosi	Bilderbuch	Mafioso
Bilderbuch-Mama	Bilderbuch	Mama
Bilderbuchmanier	Bilderbuch	Manier
Bilderbuch-Märchen	Bilderbuch	Märchen
Bilderbuchmessias	Bilderbuch	Messias
Bilderbuch-Münchener	Bilderbuch	Münchener
Bilderbuchmuseum	Bilderbuch	Museum
Bilderbuchnaturbursche	Bilderbuch	Naturbursche
Bilderbuch-Nazi	Bilderbuch	Nazi
Bilderbuch-Not	Bilderbuch	Not
Bilderbuch-Oma	Bilderbuch	Oma
Bilderbuch-Paar	Bilderbuch	Paar
Bilderbuchpaket	Bilderbuch	Paket
Bilderbuch-Panorama	Bilderbuch	Panorama
Bilderbuchpatientin	Bilderbuch	Patientin
Bilderbuchplanwagen	Bilderbuch	Planwagen
Bilderbuch-Platanenallee	Bilderbuch	Platanenallee
Bilderbuchpolizistin	Bilderbuch	Polizistin
Bilderbuch-Prag	Bilderbuch	Prag
Bilderbuchpräsident	Bilderbuch	Präsident
Bilderbuchprinzessin	Bilderbuch	Prinzessin
Bilderbuchproduktion	Bilderbuch	Produktion
Bilderbuchprogramm	Bilderbuch	Programm
Bilderbuchprojekt	Bilderbuch	Projekt
Bilderbuchputsch	Bilderbuch	Putsch
Bilderbuchreaktion	Bilderbuch	Reaktion
Bilderbuch-Referenzen	Bilderbuch	Referenz
Bilderbuchreihe	Bilderbuch	Reihe
Bilderbuchreiseführer	Bilderbuch	Reiseführer
Bilderbuchreise	Bilderbuch	Reise
Bilderbuchromantik	Bilderbuch	Romantik
Bilderbuchsadist	Bilderbuch	Sadist
Bilderbuchsaison	Bilderbuch	Saison
Bilderbuchschauen	Bilderbuch	Schau
Bilderbuch-Schildbürgerstreich	Bilderbuch	Schildbürgerstreich
Bilderbuchschloss	Bilderbuch	Schloss
Bilderbuchschmökerei	Bilderbuch	Schmökerei
Bilderbuchschreiber	Bilderbuch	Schreiber
Bilderbuchseite	Bilderbuch	Seite
Bilderbuchsommer	Bilderbuch	Sommer
Bilderbuchsommernacht	Bilderbuch	Sommernacht
Bilderbuchsonntag	Bilderbuch	Sonntag
Bilderbuch-Sozialarbeit	Bilderbuch	Sozialarbeit
Bilderbuch-Sozi	Bilderbuch	Sozi
Bilderbuchspanien	Bilderbuch	Spanien
Bilderbuch-Spaß	Bilderbuch	Spaß
Bilderbuchsprache	Bilderbuch	Sprache
Bilderbuchstadion	Bilderbuch	Stadion
Bilderbuch-Städtchen	Bilderbuch	Städtchen
Bilderbuch-Start	Bilderbuch	Start
Bilderbuchsteg	Bilderbuch	Steg
Bilderbuch-Stelle	Bilderbuch	Stelle
Bilderbuchstil	Bilderbuch	Stil
Bilderbuch-Südstaatentyp	Bilderbuch	Südstaatentyp
Bilderbuchsymptom	Bilderbuch	Symptom
Bilderbuchszene	Bilderbuch	Szene
Bilderbuch-Thema	Bilderbuch	Thema
Bilderbuchtitel	Bilderbuch	Titel
Bilderbuchtor	Bilderbuch	Tor
Bilderbuch-Türsteher	Bilderbuch	Türsteher
Bilderbuchumschlag	Bilderbuch	Umschlag
Bilderbuchvater	Bilderbuch	Vater
Bilderbuchvertreter	Bilderbuch	Vertreter
Bilderbuchvertrieb	Bilderbuch	Vertrieb
Bilderbuch-Villa	Bilderbuch	Villa
Bilderbuch-Vorfrühling	Bilderbuch	Vorfrühling
Bilderbuchvulkan	Bilderbuch	Vulkan
Bilderbuchwald	Bilderbuch	Wald
Bilderbuch-Weihnachtsmann	Bilderbuch	Weihnachtsmann
Bilderbuchwettbewerb	Bilderbuch	Wettbewerb
Bilderbuchwetter	Bilderbuch	Wetter
Bilderbuchwinter	Bilderbuch	Winter
Bilderbuchwirtshaus	Bilderbuch	Wirtshaus
Bilderbuch-Wissenschaft	Bilderbuch	Wissenschaft
Bilderbuchwitterung	Bilderbuch	Witterung
Bilderbuchwoche	Bilderbuch	Woche
Bilderbuchzeichner	Bilderbuch	Zeichner
Bilderbuch-Zeuge	Bilderbuch	Zeuge
Blitzabsprache	Blitz	Absprache
Blitzabwender	Blitz	Abwender
Blitzadapter	Blitz	Adapter
Blitzaffäre	Blitz	Affäre
Blitzaktivität	Blitz	Aktivität
Blitzampel	Blitz	Ampel
Blitzangst	Blitz	Angst
Blitzanschluss	Blitz	Anschluss
Blitzarme	Blitz	Arm
Blitzarten	Blitz	Art
Blitzäste	Blitz	Ast
Blitz-Attacke	Blitz	Attacke
Blitzaufstieg	Blitz	Aufstieg
Blitzauswertung	Blitz	Auswertung
Blitzautomat	Blitz	Automat
Blitzballspieler	Blitzball	Spieler
Blitz-Bauzeit	Blitz	Bauzeit
Blitzbeförderung	Blitz	Beförderung
Blitzbenutzung	Blitz	Benutzuung
Blitzbesichtigung	Blitz	Besichtigung
Blitz-Bewerbung	Blitz	Bewerbung
Blitzbewertung	Blitz	Bewertung
Blitzbingo	Blitz	Bingo
Blitzblähung	Blitz	Blähung
Blitzblume	Blitz	Blume
Blitzbodenkarton	Blitzboden	Karton
Blitzbomber	Blitz	Bomber
Blitzbrief	Blitz	Brief
Blitzbrille	Blitz	Brille
Blitzbulimie	Blitz	Bulimie
Blitz-Casting	Blitz	Casting
Blitzdemo	Blitz	Demo
Blitz-Deportation	Blitz	Deportation
Blitzdiagnose	Blitz	Diagnose
Blitzdichte	Blitz	Dichte
Blitzdichterin	Blitz	Dichterin
Blitzdraht	Blitz	Draht
Blitz-Ehe	Blitz	Ehe
Blitzeiche	Blitz	Eiche
Blitzeinbruch	Blitz	Einbruch
Blitzeinsatz	Blitz	Einsatz
Blitzeinschätzung	Blitz	Einschätzung
Blitzeinschlaghäufigkeit	Blitz	Einschlaghäufigkeit
Blitzeinstieg	Blitz	Einstieg
Blitzeinwirkungen	Blitz	Einwirkung
Blitzeinzelmeisterschaften	Blitz	Einzelmeisterschaft
Blitz-Eis	Blitz	Eis
Blitzelemente	Blitz	Element
Blitzentladung	Blitz	Entladung
Blitzentscheid	Blitz	Entscheid
Blitzentscheidung	Blitz	Entscheidung
Blitzerfolg	Blitz	Erfolg
Blitzerlebnis	Blitz	Erlebnis
Blitzeroberung	Blitz	Eroberung
Blitz-Evakuierung	Blitz	Evakuierung
Blitzexperte	Blitz	Experte
Blitzfähigkeiten	Blitz	Fähigkeit
Blitz-Fahrgestell	Blitz	Fahrgestell
Blitzfänger	Blitz	Fänger
Blitzfeldzug	Blitz	Feldzug
Blitzforscher	Blitz	Forscher
Blitz-Fotografie	Blitz	Fotografie
Blitzführung	Blitz	Führung
Blitzfunk	Blitz	Funk
Blitzgeber	Blitz	Geber
Blitzgeburt	Blitz	Geburt
Blitzgedanke	Blitz	Gedanke
Blitzgefrieren	Blitz	Gefrieren
Blitz-Gegentore	Blitz	Gegentor
Blitzgegner	Blitz	Gegner
Blitzgerät	Blitz	Gerät
Blitzgericht	Blitz	Gericht
Blitzgerüst	Blitz	Gerüst
Blitzgeschoss	Blitz	Geschoss
Blitzgesetzesänderung	Blitz	Gesetzesänderung
Blitzgewitter	Blitz	Gewitter
Blitz-Gipfel	Blitz	Gipfel
Blitzglut	Blitz	Glut
Blitzgruß	Blitz	Gruß
Blitzguss	Blitz	Guss
Blitzhauptverhandlung	Blitz	Hauptverhandlung
Blitz-Hefe	Blitz	Hefe
Blitzheilung	Blitz	Heilung
Blitzheirat	Blitz	Heirat
Blitzhypnose	Blitz	Hypnose
Blitz-Hypnotiseur	Blitz	Hypnotiseur
Blitzidee	Blitz	Idee
Blitzinfo	Blitz	Info
Blitzinterview	Blitz	Interview
Blitzinvasion	Blitz	Invasion
Blitzjäger	Blitz	Jäger
Blitz-Journal	Blitz	Journal
Blitzkameras	Blitz	Kamera
Blitzkampf	Blitz	Kampf
Blitzkarriere	Blitz	Karriere
Blitz-Käsekuchen	Blitz	Käsekuchen
Blitzkassiererin	Blitz	Kassiererin
Blitzkatastrophen	Blitz	Katastrophe
Blitzkegel	Blitz	Kegel
Blitzknabe	Blitz	Knabe
Blitzknallböller	Blitzknall	böller
Blitz-Knall	Blitz	Knall
Blitzkompensator	Blitz	Kompensator
Blitzkrach	Blitz	Krach
Blitzkrieg	Blitz	Krieg
Blitz-Kur	Blitz	Kur
Blitzkurs	Blitz	Kurs
Blitzlampe	Blitz	Lampe
Blitzlehre	Blitz	Lehre
Blitzleim	Blitz	Leim
Blitz-Lektion	Blitz	Lektion
Blitz-Lernen	Blitz	Lernen
Blitzlesen	Blitz	Lese
Blitz-Licht	Blitz	Licht
Blitzliteratur	Blitz	Literatur
Blitzlösung	Blitz	Lösung
Blitzmästung	Blitz	Mästung
Blitzmessadapter	Blitzmessen	Adapter
Blitzmontagen	Blitz	Montage
Blitzmörtel	Blitz	Mörtel
Blitzmuffel	Blitz	Muffel
Blitznähe	Blitz	Nähe
Blitznarbe	Blitz	Narbe
Blitzneiger	Blitz	Neiger
Blitz-News	Blitz	News
Blitzniederlage	Blitz	Niederlage
Blitzoperation	Blitz	Operation
Blitzopfern	Blitz	Opfer
Blitz-Orgasmus	Blitz	Orgasmus
Blitzortung	Blitz	Ortung
Blitzparty	Blitz	Party
Blitzpfeil	Blitz	Pfeil
Blitzprofi	Blitz	Profi
Blitz-Protestaktion	Blitz	Protestaktion
Blitzrasur	Blitz	Rasur
Blitz-Raub	Blitz	Raub
Blitz-Recherche	Blitz	Recherche
Blitzrechnens	Blitz	rechnen
Blitzrechnung	Blitz	Rechnung
Blitzreflexe	Blitz	Reflex
Blitz-Reflexionen	Blitz	Reflexion
Blitzreinigung	Blitz	Reinigung
Blitzreise	Blitz	Reise
Blitz-Remake	Blitz	Remake
Blitzresistenz	Blitz	Resistenz
Blitzrezept	Blitz	Rezept
Blitzröhre	Blitz	Röhre
Blitz-Rücktritt	Blitz	Rücktritt
Blitzsalve	Blitz	Salve
Blitzsätzen	Blitz	Satz
Blitzsauberkeit	Blitz	Sauberkeit
Blitzschach	Blitz	Schach
Blitzscheidung	Blitz	Scheidung
Blitzschicht	Blitz	Schicht
Blitzschlag	Blitz	Schlag
Blitzschwert	Blitz	Schwert
Blitzsekunde	Blitz	Sekunde
Blitzsensor	Blitz	Sensor
Blitzservice	Blitz	Service
Blitzsicherheit	Blitz	Sicherheit
Blitzsieg	Blitz	Sieg
Blitzsimulator	Blitz	Simulator
Blitzsimultankampf	Blitz	Simultankampf
Blitzsöldner	Blitz	Söldner
Blitzspezialist	Blitz	Spezialist
Blitzspieler	Blitz	Spieler
Blitzstärke	Blitz	Stärke
Blitz-Steuerung	Blitz	Steuerung
Blitzstich	Blitz	Stich
Blitzstrom	Blitz	Strom
Blitzsystem	Blitz	System
Blitztage	Blitz	Tag
Blitztätowierung	Blitz	Tätowierung
Blitztechnik	Blitz	Technik
Blitztelegram	Blitz	Telegram
Blitztest	Blitz	Test
Blitz-Tiebreak	Blitz	Tiebreak
Blitztipp	Blitz	Tipp
Blitz-Titelkampf	Blitz	Titelkampf
Blitztor	Blitz	Tor
Blitz-Totem	Blitz	Totem
Blitzträger	Blitz	Träger
Blitztreffen	Blitz	Treffen
Blitzübersichtskarte	Blitz	Übersichtskarte
Blitz-Umfrage	Blitz	Umfrage
Blitzurlaub	Blitz	Urlaub
Blitzurteil	Blitz	Urteil
Blitzverführung	Blitz	Verführung
Blitzversuch	Blitz	Versuch
Blitzvisite	Blitz	Visite
Blitz-Vormachtsstellung	Blitz	Vormachtstellung
Blitz-Vortrag	Blitz	Vortrag
Blitzwahl	Blitz	Wahl
Blitz-Wahlkampftour	Blitz	Wahlkampftour
Blitzwand	Blitz	Wand
Blitzwechsel	Blitz	Wechsel
Blitzwelle	Blitz	Welle
Blitz-Widerstand	Blitz	Widerstand
Blitz-Wochenende	Blitz	Wochenende
Blitzzauber	Blitz	Zauber
Blitzzügen	Blitz	Zug
Bombenabwurfgebiet	Bombenabwurf	Gebiet
Bomben-Abwurf-Platz	Bombenabwurf	Platz
Bombenabwurf	Bombe	Abwurf
Bombenabwurftestgelände	Bombenabwurf	Testgelände
Bombenabwurfzone	Bombenabwurf	Zone
Bombenalarm	Bombe	Alarm
Bombenanschlagabwehr-Trupp	Bombenanschlag	Abwehrtrupp
Bomben-Arbeitsplatz	Bomben	Arbeitsplatz
Bombenarsenal	Bombe	Arsenal
Bombenattacke	Bombe	Attacke
Bomben-Attentäter	Bomben	Attentäter
BOMBEN-ATTENTAT	Bomben	Attentat
Bombenattrappe	Bombe	Attrappe
Bombenauftakt	Bombe	Auftakt
Bombenbastelei	Bombe	Bastelei
Bombenbauer	Bombe	Bauer
Bombenbeginn	Bombe	Beginn
Bombenbehälter	Bombe	Behälter
Bombenbeitrag	Bombe	Beitrag
Bombenbekämpfung	Bombe	Bekämpfung
Bomben-Beschluß	Bomben	Beschluss
Bomben-Blindgänger	Bomben	Blindgänger
Bombenchance	Bombe	Chance
Bombendesign	Bombe	Design
Bombendetektor	Bombe	Detektor
Bombendetonation	Bombe	Detonation
Bombendiktat	Bombe	Diktat
Bombending	Bombe	Ding
Bombendrama	Bombe	Drama
Bombendröhnen	Bombe	dröhnen
Bombendrohung	Bombe	Drohung
Bombeneinsatzkommando	Bombe	Einsatzkommando
Bombeneinstand	Bombe	Einstand
Bombeneinwirkung	Bombe	Einwirkung
Bombenentschärfung	Bombe	Entschärfung
Bomben-Entscheidung	Bombe	Entscheidung
Bombenergebnis	Bombe	Ergebnis
Bombenevakuierte	Bombe	Evakuierter
Bomben-Experte	Bomben	Experte
Bombenexplosion	Bombe	Explosion
Bombenfächer	Bombe	Fach
Bomben-Falle	Bomben	Falle
Bombenfallout	Bombe	Fallout
Bombenfamilie	Bombe	Familie
Bombenfehlalarme	Bombe	Fehlalarm
Bombenfehlwurf	Bombe	Fehlwurf
Bombenfeuerwerk	Bombe	Feuerwerk
Bombenfimmel	Bombe	Fimmel
Bombenfliegern	Bombe	Flieger
Bombenflüchtlingsfahrt	Bombenflüchtling	Fahrt
Bombenfolter	Bombe	Folter
Bombenform	Bombe	Form
Bombenfreistoß	Bombe	Freistoß
Bombenfund	Bombe	Fund
Bombengaudi	Bombe	Gaudi
Bombengedröhn	Bombe	Gedröhn
Bombengeknalle	Bombe	Geknalle
Bombengeschwader	Bombe	Geschwader
Bombengestell	Bombe	Gestell
Bombengewicht	Bombe	Gewicht
Bombengewitter	Bombe	Gewitter
Bombengott	Bombe	Gott
Bombengräuel	Bombe	Gräuel
Bombengründen	Bombe	Grund
Bombengürtel	Bombe	Gürtel
Bombenhagel	Bombe	Hagel
Bombenhersteller	Bombe	Hersteller
Bombenhirn	Bombe	Hirn
Bombenhund	Bombe	Hund
Bomben-Hysterie	Bomben	Hysterie
Bombenidee	Bombe	Idee
Bombeninferno	Bombe	Inferno
Bombeningenieur	Bombe	Ingenieur
Bombenjahr	Bombe	Jahr
Bomben-Job	Bomben	Job
Bombenjunge	Bombe	Junge
Bomben-Kader	Bomben	Kader
Bombenkalorimetrie	Bombe	Kalorimetrie
Bombenkampagne	Bombe	Kampagne
Bombenkandelaber	Bombe	Kandelaber
Bombenkanone	Bombe	Kanone
Bombenkanzler	Bombe	Kanzler
Bombenkarriere	Bombe	Karriere
Bombenkern	Bombe	Kern
Bombenkessel	Bombe	Kessel
Bombenkette	Bombe	Kette
Bombenkinder	Bombe	Kind
Bombenkippe	Bombe	Kippe
Bombenkoffer	Bombe	Koffer
Bomben-Kombination	Bomben	Kombination
Bombenkomponenten	Bombe	Komponente
Bomben-Kondition	Bomben	Kondition
Bombenkongress	Bombe	Kongress
Bombenkörper	Bombe	Körper
Bombenkrater	Bombe	Krater
Bomben-Krieg	Bomben	Krieg
Bombenkugel	Bombe	Kugel
Bombenkurs	Bombe	Kurs
Bombenladeraum	Bombe	Laderaum
Bombenlauf	Bombe	Lauf
Bombenlaune	Bombe	Laune
Bombenleger	Bombe	Leger
Bomben-Leistung	Bomben	Leistung
Bombenlied	Bombe	Lied
Bomben-Luke	Bomben	Luke
Bomben-Marktanteil	Bomben	Marktanteil
Bomben-Massenmassaker	Bomben	Massenmassaker
Bomben-Mission	Bomben	Mission
Bombenmodus	Bombe	Modus
Bombenmörser	Bombe	Mörser
Bombennacht	Bombe	Nacht
Bombenneigung	Bombe	Neigung
Bombenneurose	Bombe	Neurose
Bombenopfergräberfeld	Bombenopfer	Gräberfeld
Bombenopfer	Bombe	Opfer
Bombenpeter	UNKNOWN	UNKNOWN
Bombenplatte	Bombe	Platte
Bombenplatz	Bombe	Platz
Bombenpolitik	Bombe	Politik
Bombenpotential	Bombe	Potential
Bombenpraxis	Bombe	Praxis
Bombenpreis	Bombe	Preis
Bomben-Produktionsstätte	Bomben	Produktionsstätte
Bombenprozeß	Bombe	Prozess
Bombenquote	Bombe	Quote
Bomben-Rakete	Bomben	Rakete
Bombenräumung	Bombe	Räumung
Bombenreklame	Bombe	Reklame
Bombenreportage	Bombe	Reportage
Bombenrest	Bombe	Rest
Bombenrichtgerät	Bombe	Richtgerät
Bombenring	Bombe	Ring
Bombenritt	Bombe	Ritt
Bombenrohr	Bombe	Rohr
Bombenrücklaufergebnis	Bombe	Rücklaufergebnis
Bombenruine	Bombe	Ruine
Bombensalve	Bombe	Salve
Bombenschacht	Bombe	Schacht
Bombenschaden	Bombe	Schaden
Bombenschlacht	Bombe	Schlacht
Bombenschmeißen	Bombe	schmeißen
Bomben-Schmuggel	Bomben	Schmuggel
Bombenschnitt	Bombe	Schnitt
Bombenschock	Bombe	Schock
Bombenschutt	Bombe	Schutt
Bombenschutzkeller	Bombenschutz	Keller
Bombenserie	Bombe	Serie
Bombensicherheit	Bombe	Sicherheit
Bombensituation	Bombe	Situation
Bombensoftware	Bombe	Software
Bomben-Spaß	Bomben	Spaß
Bombenspektakel	Bombe	Spektakel
Bombenspezialist	Bombe	Spezialist
Bombenspielplatz	Bombe	Spielplatz
Bombensplitter	Bombe	Splitter
Bombensprengung	Bombe	Sprengung
Bombenspuren	Bombe	Spur
Bombenspurt	Bombe	Spurt
Bombenstart	Bombe	Start
Bombenstoff	Bombe	Stoff
Bombenstürmen	Bombe	Sturm
Bombensucharbeiten	Bombensuche	Arbeit
Bombentänzer	Bombe	Tänzer
Bombentasche	Bombe	Tasche
Bombenteam	Bombe	Team
Bombentechnik	Bombe	Technik
Bombentechnologie	Bombe	Technologie
Bombenteil	Bombe	Teil
Bombenteppich	Bombe	Teppich
Bombenterror	Bombe	Terror
Bombentest	Bombe	Test
Bombenthema	Bombe	Thema
Bombenthese	Bombe	These
Bombentoter	Bombe	tot
Bombentrack	Bombe	Track
Bombentrichter	Bombe	Trichter
Bombentruppe	Bombe	Truppe
Bombenüberraschung	Bombe	Überraschung
Bomben-Unfall	Bomben	Unfall
Bombenunglück	Bombe	Unglück
Bombenverbindung	Bombe	Verbindung
Bombenverdacht	Bombe	Verdacht
Bombenverschwörung	Bombe	Verschwörung
Bomben-Verstärker	Bomben	Verstärker
Bombenversteck	Bombe	Versteck
Bomben-Verwundungen	Bomben	Verwundung
Bomben-Verzögerung	Bomben	Verzögerung
Bombenvolltreffer	Bombe	Volltreffer
Bombenvorhaben	Bombe	Vorhaben
Bombenwahlerfolg	Bombe	Wahlerfolg
Bombenwarnung	Bombe	Warnung
Bombenwein	Bombe	Wein
Bombenwerfer	Bombe	Werfer
Bombenweste	Bombe	Weste
Bombenwetter	Bombe	Wetter
Bombenwitz	Bombe	Witz
Bombenwoche	Bombe	Woche
Bomben-Wochen	Bomben	Woche
Bombenwurfangriff	Bombe	Wurfangriff
Bomben-Zündkabel	Bomben	Zündkabel
Bomben-Zündung	Bomben	Zündung
Glanzabend	Glanz	Abend
Glanzabitur	Glanz	Abitur
Glanzakrobat	Glanz	Akrobat
Glanzaktion	Glanz	Aktion
Glanzakzent	Glanz	Akzent
Glanzanteil	Glanz	Anteil
Glanzarbeit	Glanz	Arbeit
Glanzargument	Glanz	Argument
Glanzaufnahme	Glanz	Aufnahme
Glanzauftritt	Glanz	Auftritt
Glanzauge	Glanz	Auge
Glanzausrüstungsmittel	Glanzausrüstung	Mittel
Glanzbeere	Glanz	Beere
Glanzbeispiel	Glanz	Beispiel
Glanzbelag	Glanz	Belag
Glanzbereich	Glanz	Bereich
Glanzbeschichtung	Glanz	Beschichtung
Glanzbesetzung	Glanz	Besetzung
Glanzbezug	Glanz	Bezug
Glanzbildchen	Glanz	Bildchen
Glanzbild	Glanz	Bild
Glanzblech	Glanz	Blech
Glanzbrand	Glanz	Brand
Glanzbroschüre	Glanz	Broschüre
Glanzcomeback	Glanz	Comeback
Glanzcover	Glanz	Cover
Glanzcreme	Glanz	Creme
Glanzdarstellung	Glanz	Darstellung
Glanzdekade	Glanz	Dekade
Glanz-Disziplin	Glanz	Disziplin
Glanz-Effekt	Glanz	Effekt
Glanzeigenschaften	Glanz	Eigenschaft
Glanzeinsatz	Glanz	Einsatz
Glanz-Email-Masse	Glanzemail	Masse
Glanzemulsion	Glanz	Emulsion
Glanzente	Glanz	Ente
Glanzentfaltung	Glanz	Entfaltung
Glanzepisode	Glanz	Episode
Glanzepoche	Glanz	Epoche
Glanzesfunke	Glanz	Funke
Glanzextemporale	Glanz	Extemporale
Glanzfach	Glanz	Fach
Glanzfahrt	Glanz	Fahrt
Glanzfarbe	Glanz	Farbe
Glanzfasan	Glanz	Fasan
Glanzfassade	Glanz	Fassade
Glanzfehler	Glanz	Fehler
Glanzfeinheit	Glanz	Feinheit
Glanzfeld	Glanz	Feld
Glanzfigur	Glanz	Figur
Glanzfleck	Glanz	Fleck
Glanzflut	Glanz	Flut
Glanzfolge	Glanz	Folge
Glanzfolie	Glanz	Folie
Glanzformat	Glanz	Format
Glanzform	Glanz	Form
Glanzfuge	Glanz	Fuge
Glanz-Gag	Glanz	Gag
Glanzgänse	Glanz	Gans
Glanzgarn	Glanz	Garn
Glanzgefieder	Glanz	Gefieder
Glanzgefilde	Glanz	Gefilde
Glanzgesicht	Glanz	Gesicht
Glanzgestein	Glanz	Gestein
Glanzgold	Glanz	Gold
Glanzgrad	Glanz	Grad
Glanzhaare	Glanz	Haar
Glanzhaut	Glanz	Haut
Glanzheftchen	Glanz	Heftchen
Glanzheide	Glanz	Heide
Glanzhelm	Glanz	Helm
Glanzhose	Glanz	Hose
Glanzhure	Glanz	Hure
Glanzidee	Glanz	Idee
Glanzjahr	Glanz	Jahr
Glanzkäfer	Glanz	Käfer
Glanz-Kapitel	Glanz	Kapitel
Glanzkarriere	Glanz	Karriere
Glanzkartonbogen	Glanzkarton	Bogen
Glanzkarton	Glanz	Karton
Glanzkattun	Glanz	Kattun
Glanzkino	Glanz	Kino
Glanz-Klasse	Glanz	Klasse
Glanzkölbchen	Glanz	Kölbchen
Glanz-Komödie	Glanz	Komödie
Glanzkraut	Glanz	Kraut
Glanzkreiß	Glanz	Kreiß
Glanzkupfer	Glanz	Kupfer
Glanzkür	Glanz	Kür
Glanzkuren	Glanz	Kur
Glanzlauf	Glanz	Lauf
Glanzleder	Glanz	Leder
Glanzleggings	UNKNOWN	UNKNOWN
Glanzleinen	Glanz	Leinen
Glanzleinwand	Glanz	Leinwand
Glanzleistung	Glanz	Leistung
Glanzlicht	Glanz	Licht
Glanzlidschatten	Glanz	Lidschatten
Glanzliebe	Glanz	Liebe
Glanzlook	Glanz	Look
Glanzmagazinen	Glanz	Magazin
Glanzmähne	Glanz	Mähne
Glanzmarkierungen	Glanz	Markierung
Glanzmeer	Glanz	Meer
Glanzminute	Glanz	Minute
Glanzmittel	Glanz	Mittel
Glanzmoment	Glanz	Moment
Glanznägel	Glanz	Nagel
Glanzniveau	Glanz	Niveau
Glanznoten	Glanz	Note
Glanznummer	Glanz	Nummer
Glanz-Optik	Glanz	Optik
Glanzorchester	Glanz	Orchester
Glanzpaket	Glanz	Paket
Glanzpapier	Glanz	Papier
Glanzpapierprospekt	Glanzpapier	Prospekt
Glanzparade	Glanz	Parade
Glanzpartie	Glanz	Partie
Glanzpartikel	Glanz	Partikel
Glanzpassage	Glanz	Passage
Glanzpass	Glanz	Pass
Glanzperiode	Glanz	Periode
Glanzphase	Glanz	Phase
Glanzpigmente	Glanz	Pigment
Glanzpolitur	Glanz	Politur
Glanzpostkarte	Glanz	Postkarte
Glanzpremiere	Glanz	Premiere
Glanzprospekt	Glanz	Prospekt
Glanzpunkt	Glanz	Punkt
Glanzreaktion	Glanz	Reaktion
Glanzreflexion	Glanz	Reflexion
Glanzresultat	Glanz	Resultat
Glanzritt	Glanz	Ritt
Glanzrolle	Glanz	Rolle
Glanzrose	Glanz	Rose
Glanzrouge	Glanz	Rouge
Glanzrunde	Glanz	Runde
Glanzrüschen	Glanz	Rüsche
Glanzruß	Glanz	Ruß
Glanzsaat	Glanz	Saat
Glanzsaison	Glanz	Saison
Glanzsamen	Glanz	Samen
Glanzschicht	Glanz	Schicht
Glanzschülerin	Glanz	Schülerin
Glanzschuppen	Glanz	Schuppe
Glanzseide	Glanz	Seide
Glanzseife	Glanz	Seife
Glanzseite	Glanz	Seite
Glanzsendung	Glanz	Sendung
Glanzshampoo	Glanz	Shampoo
Glanzshorts	Glanz	Shorts
Glanzsieg	Glanz	Sieg
Glanzsiegel	Glanz	Siegel
Glanzsignal	Glanz	Signal
Glanzsilber	Glanz	Silber
Glanzsittiche	Glanz	Sittich
Glanzspray	Glanz	Spray
Glanzspüler	Glanz	Spüler
Glanzspülung	Glanz	Spülung
Glanzstar	Glanz	Star
Glanzstart	Glanz	Start
Glanzstein	Glanz	Stein
Glanzstellen	Glanz	Stelle
Glanz-Sterbe-Arie	Glanz	Sterbearie
Glanzstern	Glanz	Stern
Glanzstiefel	Glanz	Stiefel
Glanzstoff	Glanz	Stoff
Glanzstrauch	Glanz	Strauch
Glanzstreifen	Glanz	Streifen
Glanzstrumpfhose	Glanz	Strumpfhose
Glanzstück	Glanz	Stück
Glanzstückchen	Glanz	Stückchen
Glanzstunde	Glanz	Stunde
Glanzsucht	Glanz	Sucht
Glanztat	Glanz	Tat
Glanztisch	Glanz	Tisch
Glanztongefäß	Glanzton	Gefäß
Glanztonüberzug	Glanzton	Überzug
Glanztor	Glanz	Tor
Glanztrocknung	Glanz	Trocknung
Glanztupfer	Glanz	Tupfer
Glanzturnier	Glanz	Turnier
Glanzumschlag	Glanz	Umschlag
Glanzuniversität	Glanz	Universität
Glanzunterschiede	Glanz	Unterschied
Glanzvergoldung	Glanz	Vergoldung
Glanzviertel	Glanz	Viertel
Glanzvision	Glanz	Vision
Glanzvorstellung	Glanz	Vorstellung
Glanzvortrag	Glanz	Vortrag
Glanzwahl	Glanz	Wahl
Glanzwelt	Glanz	Welt
Glanzwerke	Glanz	Werk
Glanzwinkel	Glanz	Winkel
Glanzwirkung	Glanz	Wirkung
Glanzwoche	Glanz	Woche
Glanz-Wolfsmilch	Glanz	Wolfmilch
Glanzwort	Glanz	Wort
Glanzzeit	Glanz	Zeit
Glanzziegel	Glanz	Ziegel
Glanzzwiebel	Glanz	Zwiebel
Heidenachtung	Heide	Achtung
Heidenadler	Heide	Adler
Heidenaltar	Heide	Altar
Heidenangst	Heide	Angst
Heidenanhänger	Heide	Anhänger
Heidenanstrengung	Heide	Anstrengung
Heidenapostel	Heide	Apostel
Heidenarbeit	Heide	Arbeit
Heidenärger	Heide	Ärger
Heidenarmee	Heide	Armee
Heidenaufriss	Heide	Aufriss
Heidenaufstand	Heide	Aufstand
Heidenaufwand	Heide	Aufwand
Heidenbammel	Heide	Bammel
Heidenbau	Heide	bauen
Heidenbaum	Heide	Baum
Heidenbekehrung	Heide	Bekehrung
Heidenbelagerung	Heide	Belagerung
Heidenbeschreibung	Heide	Beschreibung
Heidenbewegung	Heide	Bewegung
Heidenbezwinger	Heide	Bezwinger
Heidenblamage	Heide	Blamage
Heidenblütenzeit	Heidenblüte	Zeit
Heidenblut	Heide	Blut
Heidenbrauch	Heide	Brauch
Heidenbrut	Heide	Brut
Heidenburg	Heide	Burg
Heidenchor	Heide	Chor
Heidenchristen	Heide	Christ
Heidenchristenheit	Heide	Christenheit
Heidenchristentum	Heide	Christentum
Heidendorf	Heide	Dorf
Heidendusel	Heide	Dusel
Heidenepos	Heide	Epos
Heidenescher	Heide	Escher
Heidenfahne	Heide	Fahne
Heidenfahrt	Heide	Fahrt
Heidenfeld	Heide	Feld
Heidenfeste	Heide	Fest
Heidenfest	Heide	Fest
Heidenfeuer	Heide	Feuer
Heidenforum	Heide	Forum
Heidenfrauen	Heide	Frau
Heidenfrau	Heide	Frau
Heidenfreude	Heide	Freude
Heidenfurcht	Heide	Furcht
Heidenfürst	Heide	Fürst
Heidengarten	Heide	Garten
Heidengaudi	Heide	Gaudi
Heidengeister	Heide	Geist
Heidengeist	Heide	Geist
Heidengejohle	Heide	johlen
Heidengeld	Heide	Geld
Heidengemeinde	Heide	Gemeinde
Heidengemeinschaft	Heide	Gemeinschaft
Heidengenosse	Heide	Genosse
Heidengermanen	Heide	Germane
Heidengeschäft	Heide	Geschäft
Heidengeschichten	Heide	Geschichte
Heidengesellschaft	Heide	Gesellschaft
Heidengesocks	Heide	Gesocks
Heidengestalten	Heide	Gestalt
Heidengewinn	Heide	Gewinn
Heiden	Heide	Heide
Heidenglaube	Heide	Glaube
Heidenglück	Heide	Glück
Heidengötter	Heide	Gott
Heidengott	Heide	Gott
Heidengraben	Heide	Graben
Heidengräber	Heide	Grab
Heidengrab	Heide	Grab
Heidengut	Heide	Gut
Heidenhain	Heide	Hain
Heidenhäuser	Heide	Haus
Heidenhaus	Heide	Haus
Heidenhonorar	Heide	Honorar
Heidenhorde	Heide	Horde
Heidenjunge	Heide	Junge
Heidenjux	Heide	Jux
Heidenkampf	Heide	Kampf
Heidenkäse	Heide	Käse
Heidenkate	Heide	Kate
Heidenkäte	Heide	Käte
Heidenkäthe	Heide	Käthe
Heidenkinder	Heide	Kind
Heidenkind	Heide	Kind
Heidenkindlein	Heide	Kindlein
Heidenkirche	Heide	Kirche
Heidenkirchhof	Heide	Kirchhof
Heidenkohle	Heide	Kohle
Heidenkönig	Heide	König
Heidenkopf	Heide	Kopf
Heidenkrach	Heide	Krach
Heidenkral	Heide	Kral
Heidenkrieg	Heide	Krieg
Heidenkult	Heide	Kult
Heidenlande	Heide	Land
Heidenland	Heide	Land
Heiden-Lärm	Heide	Lärm
Heidenlehre	Heide	Lehre
Heidenlied	Heide	Lied
Heidenmailingliste	Heide	Mailingliste
Heidenmal	Heide	Mal
Heidenmami	Heide	Mami
Heidenmarterl	Heide	Marterl
Heidenmassakrieren	Heide	Massakrieren
Heidenmasse	Heide	Masse
Heidenmauer	Heide	Mauer
Heidenmissionar	Heide	Missionar
Heidenmissionierung	Heide	Missionierung
Heidenmissionsarbeit	Heide	Missionsarbeit
Heidenmissionsgottesdienst	Heide	Missionsgottesdienst
Heidenmisssion	Heide	Mission
Heidenmord	Heide	Mord
Heidenmühe	Heide	Mühe
Heidenmütter	Heide	Mutter
Heiden-Mystik-Forum	Heidenmystik	Forum
Heidennacht	Heide	Nacht
Heidenoldendorf	Heide	Oldendorf
Heidenopfer	Heide	Opfer
Heidenpack	Heide	Pack
Heidenpastor	Heide	Pastor
Heidenpech	Heide	Pech
Heiden-Peter	Heiden	Peter
Heidenpredigt	Heide	Predigt
Heidenpriester	Heide	Priester
Heidenprozession	Heide	Prozession
Heidenqual	Heide	Qual
Heidenquatsch	Heide	Quatsch
Heidenquelle	Heide	Quelle
Heidenrabbi	Heide	Rabbi
Heidenradau	Heide	Radau
Heidenreligion	Heide	Religion
Heidenreligon	Heide	Religion
Heidenrespekt	Heide	Respekt
Heidenriegel	Heide	Riegel
Heidenrunde	Heide	Runde
Heidenschanze	Heide	Schanze
Heidenscharen	Heide	Schar
Heidenschar	Heide	Schar
Heidenscheich	Heide	Scheich
Heidenschiss	Heide	Schiss
Heidenschlächterei	Heide	Schlächterei
Heidenschloss	Heide	Schloss
Heidenschotter	Heide	Schotter
Heidenschrecken	Heide	Schrecken
Heidenschule	Heide	Schule
Heidenschuß	Heide	Schuss
Heidenseele	Heide	Seele
Heidensender	Heide	Sender
Heidensieg	Heide	Sieg
Heidensinn	Heide	Sinn
Heidensklave	Heide	Sklave
Heidensohn	Heide	Sohn
Heidenspass	Heide	Spaß
Heidenspaß	Heide	Spaß
Heidenspinner	Heide	Spinner
Heidenspuk	Heide	Spuk
Heidenstamm	Heide	Stamm
Heidenstecker	Heide	Stecker
Heidenstein	Heide	Stein
Heidenstieg	Heide	steigen
Heidenstolz	Heide	Stolz
Heidenstrasse	Heide	Straße
Heidenstraße	Heide	Straße
Heidenstress	Heide	Stress
Heidenstube	Heide	Stube
Heidensymbol	Heide	Symbol
Heiden-Symbolik	Heiden	Symbolik
Heidenszene	Heide	Szene
Heidentaufe	Heide	Taufe
Heidentäufer	Heide	täufer
Heiden-Teil	Heiden	Teil
Heidentempo	Heide	Tempo
Heidentheater	Heide	Theater
Heidentore	Heide	Tor
Heidentöten	Heide	Töten
Heidentradition	Heide	Tradition
Heidentürmchen	Heide	Türmchen
Heidenturm	Heide	Turm
Heidenüberraschung	Heide	Überraschung
Heidenumsatz	Heide	Umsatz
Heidenunrat	Heide	Unrat
Heidenverehrer	Heide	Verehrer
Heidenverfolgung	Heide	Verfolgung
Heidenvergnügen	Heide	Vergnügen
Heidenverlag	Heide	Verlag
Heidenvölker	Heide	Volk
Heidenvolk	Heide	Volk
Heidenwahn	Heide	Wahn
Heidenwall	Heide	Wall
Heidenweib	Heide	Weib
Heiden-Welt	Heiden	Welt
Heidenwerfen	Heide	werfen
Heidenwerk	Heide	Werk
Heidenwirt	Heide	Wirt
Heidenwochenende	Heide	Wochenende
Heidenwut	Heide	Wut
Heidenzeiten	Heide	Zeit
Heidenzeit	Heide	Zeit
Heidenzorn	Heide	Zorn
Jahrhundertabstand	Jahrhundert	Abstand
Jahrhundert-Alben	Jahrhundert	Album
Jahrhundertalent	Jahrhundert	Talent
Jahrhundertangabe	Jahrhundert	Angabe
Jahrhundert-Athletin	Jahrhundert	Athletin
Jahrhundert-Attentat	Jahrhundert	Attentat
Jahrhundertaufgabe	Jahrhundert	Aufgabe
Jahrhundertaufzeichnungen	Jahrhundert	Aufzeichnung
Jahrhundertaugust	Jahrhundert	August
Jahrhundertausgabe	Jahrhundert	Ausgabe
Jahrhundertausgang	Jahrhundert	Ausgang
Jahrhundertausklang	Jahrhundert	Ausklang
Jahrhundertauswahl	Jahrhundert	Auswahl
Jahrhundertautor	Jahrhundert	Autor
Jahrhundert-Baby	Jahrhundert	Baby
Jahrhundertbaisse	Jahrhundert	Baisse
Jahrhundertbau	Jahrhundert	bauen
Jahrhundertbegabung	Jahrhundert	Begabung
Jahrhundertbeginn	Jahrhundert	Beginn
Jahrhundertbegriff	Jahrhundert	Begriff
Jahrhundertbesuch	Jahrhundert	Besuch
Jahrhundertbetrachtung	Jahrhundert	Betrachtung
Jahrhundertbetrug	Jahrhundert	Betrug
Jahrhundertbilanz	Jahrhundert	Bilanz
Jahrhundertblamage	Jahrhundert	Blamage
Jahrhundert-Bücher	Jahrhundert	Buch
Jahrhundertbyte	Jahrhundert	Byte
Jahrhundert-Cellist	Jahrhundert	Cellist
Jahrhundertchirurg	Jahrhundert	Chirurg
Jahrhundertchronik	Jahrhundert	Chronik
Jahrhundertcollage	Jahrhundert	Collage
Jahrhundertdeal	Jahrhundert	Deal
Jahrhundertdenkmal	Jahrhundert	Denkmal
Jahrhundertdeutscher	Jahrhundert	deutsch
Jahrhundertdrama	Jahrhundert	Drama
Jahrhundertdurchschnitt	Jahrhundert	Durchschnitt
Jahrhundert-Edition	Jahrhundert	Edition
Jahrhundert-El-Nino	Jahrhundert	El-Nino
Jahrhundertende	Jahrhundert	Ende
Jahrhundertentdeckung	Jahrhundert	Entdeckung
Jahrhundertentwicklung	Jahrhundert	Entwickelung
Jahrhundertenwende	Jahrhundert	Wende
Jahrhundert-Erdbeben	Jahrhundert	Erdbeben
Jahrhunderterfindung	Jahrhundert	Erfindung
Jahrhunderterfolg	Jahrhundert	Erfolg
Jahrhunderterinnerung	Jahrhundert	Erinnerung
Jahrhundert-Fahrer	Jahrhundert	Fahrer
Jahrhundert-Februar	Jahrhundert	Februar
Jahrhundertfeier	Jahrhundert	Feier
Jahrhundert-Feldzug	Jahrhundert	Feldzug
Jahrhundertfest	Jahrhundert	Fest
Jahrhundertfeuerwerk	Jahrhundert	Feuerwerk
Jahrhundert-Figur	Jahrhundert	Figur
Jahrhundert-Film	Jahrhundert	Film
Jahrhundertflopp	Jahrhundert	Flop
Jahrhundertflugzeug	Jahrhundert	Flugzeug
Jahrhundert-Flut	Jahrhundert	Flut
Jahrhundertformel	Jahrhundert	Formel
Jahrhundertfotograf	Jahrhundert	Fotograf
Jahrhundertfrage	Jahrhundert	Frage
Jahrhundertfrost	Jahrhundert	Frost
Jahrhundertfund	Jahrhundert	Fund
Jahrhundert-Fußballer	Jahrhundert	Fußballer
Jahrhundertgärtner	Jahrhundert	Gärtner
Jahrhundertgedächtnis	Jahrhundert	Gedächtnis
Jahrhundertgedicht	Jahrhundert	Gedicht
Jahrhundertgeheimnis	Jahrhundert	Geheimnis
Jahrhundertgeiger	Jahrhundert	Geiger
Jahrhundertgelächter	Jahrhundert	Gelächter
Jahrhundertgenie	Jahrhundert	Genie
Jahrhundert-Geschäft	Jahrhundert	Geschäft
Jahrhundertgeschichte	Jahrhundert	Geschichte
Jahrhundertgesicht	Jahrhundert	Gesicht
Jahrhundertgipfel	Jahrhundert	Gipfel
Jahrhundert-Goldschatzfund	Jahrhundert	Goldschatzfund
Jahrhunderthälfte	Jahrhundert	Hälfte
Jahrhunderthandballer	Jahrhundert	Handballer
Jahrhundertheld	Jahrhundert	Held
Jahrhunderthitze	Jahrhundert	Hitze
Jahrhunderthochwasser	Jahrhundert	Hochwasser
Jahrhundert-Hund	Jahrhundert	Hund
Jahrhundert-Hurrikan	Jahrhundert	Hurrikan
Jahrhundert-Idol	Jahrhundert	Idol
Jahrhundert-Ingenieur	Jahrhundert	Ingenieur
Jahrhundertirrtum	Jahrhundert	Irrtum
Jahrhundertjahrgang	Jahrhundert	Jahrgang
Jahrhundertjubiläum	Jahrhundert	Jubiläum
Jahrhundertkardinal	Jahrhundert	Kardinal
Jahrhundertkatastophe	Jahrhundert	Katastrophe
Jahrhundert-Katastrophe	Jahrhundert	Katastrophe
Jahrhundertkerl	Jahrhundert	Kerl
Jahrhundert-Killer	Jahrhundert	Killer
Jahrhundertklassiker	Jahrhundert	Klassiker
Jahrhundertkoalition	Jahrhundert	Koalition
Jahrhundertkoch	Jahrhundert	Koch
Jahrhundert-Komet	Jahrhundert	Komet
Jahrhundert-Komiker	Jahrhundert	Komiker
Jahrhundertkonkurrenz	Jahrhundert	Konkurrenz
Jahrhundertkreis	Jahrhundert	Kreis
Jahrhundertkünstler	Jahrhundert	Künstler
Jahrhundertkünstlerin	Jahrhundert	Künstlerin
Jahrhundertläufer	Jahrhundert	Läufer
Jahrhundertleben	Jahrhundert	Leben
Jahrhundert-Legende	Jahrhundert	Legende
Jahrhundertlehrplan	Jahrhundert	Lehrplan
Jahrhundertliteratur	Jahrhundert	Literatur
Jahrhundertlohn	Jahrhundert	Lohn
Jahrhundertmagier	Jahrhundert	Magier
Jahrhundertmarke	Jahrhundert	Marke
Jahrhundertmedizin	Jahrhundert	Medizin
Jahrhundertmelodie	Jahrhundert	Melodie
Jahrhundertmensch	Jahrhundert	Mensch
Jahrhundertmenü	Jahrhundert	Menü
Jahrhundert-Mittelwert	Jahrhundert	Mittelwert
Jahrhundert-Mitte	Jahrhundert	Mitte
Jahrhundert-Mord	Jahrhundert	Mord
Jahrhundertmythos	Jahrhundert	Mythos
Jahrhundert-Nacht	Jahrhundert	Nacht
Jahrhundert-Orkan	Jahrhundert	Orkan
Jahrhundertphilosoph	Jahrhundert	Philosoph
Jahrhundertphysiker	Jahrhundert	Physiker
Jahrhundertplan	Jahrhundert	Plan
Jahrhundertpleite	Jahrhundert	Pleite
Jahrhundert-Pontifikat	Jahrhundert	Pontifikat
Jahrhundertprägung	Jahrhundert	prägung
Jahrhundertproblem	Jahrhundert	Problem
Jahrhundertprojekt	Jahrhundert	Projekt
Jahrhundertprozess	Jahrhundert	Prozess
Jahrhundert-Qualität	Jahrhundert	Qualität
Jahrhundertrecycling	Jahrhundert	Recycling
Jahrhundertregen	Jahrhundert	Regen
Jahrhundertregenfall	Jahrhundert	Regenfall
Jahrhundertreihe	Jahrhundert	Reihe
Jahrhundert-Rekord	Jahrhundert	Rekord
Jahrhundertringe	Jahrhundert	Ring
Jahrhundert-Rückblick	Jahrhundert	Rückblick
Jahrhundertsänger	Jahrhundert	Singer
Jahrhundertsatire	Jahrhundert	Satire
Jahrhundertschäden	Jahrhundert	Schaden
Jahrhundertschatz	Jahrhundert	Schatz
Jahrhundertschauspiel	Jahrhundert	Schauspiel
Jahrhundertschauspieler	Jahrhundert	Schauspieler
Jahrhundertschicksal	Jahrhundert	Schicksal
Jahrhundertschlaf	Jahrhundert	Schlaf
Jahrhundertschluß	Jahrhundert	Schluss
Jahrhundertschneesturm	Jahrhundert	Schneesturm
Jahrhundertschuld	Jahrhundert	Schuld
Jahrhundertschwindel	Jahrhundert	Schwindel
Jahrhundertserie	Jahrhundert	Serie
Jahrhundertshälfte	Jahrhundert	Hälfte
Jahrhundertsignatur	Jahrhundert	Signatur
Jahrhundertsommer	Jahrhundert	Sommer
Jahrhundert-Song	Jahrhundert	Song
Jahrhundertsopranistin	Jahrhundert	Sopranistin
Jahrhundertspektakel	Jahrhundert	Spektakel
Jahrhundertspiele	Jahrhundert	Spiel
Jahrhundert-Sportlerin	Jahrhundert	Sportlerin
Jahrhundertspruch	Jahrhundert	Spruch
Jahrhundertsprung	Jahrhundert	Sprung
Jahrhundertsregen	Jahrhundert	Regen
Jahrhundertstar	Jahrhundert	Star
Jahrhundert-Steuerreform	Jahrhundert	Steuerreform
Jahrhundert-Story	Jahrhundert	Story
Jahrhundertstreik	Jahrhundert	Streik
Jahrhundertstreit	Jahrhundert	Streit
Jahrhundertsturm	Jahrhundert	Sturm
Jahrhundertsühne	Jahrhundert	Sühne
Jahrhunderttaifun	Jahrhundert	Taifun
Jahrhunderttakt	Jahrhundert	Takt
Jahrhunderttalente	Jahrhundert	Talent
Jahrhundertthema	Jahrhundert	Thema
Jahrhunderttief	Jahrhundert	Tief
Jahrhundert-Tor	Jahrhundert	Tor
Jahrhundert-Tradition	Jahrhundert	Tradition
Jahrhundert-Trainer	Jahrhundert	Trainer
Jahrhundert-Treffen	Jahrhundert	Treffen
Jahrhunderttreffer	Jahrhundert	Treffer
Jahrhundertturm	Jahrhundert	Turm
Jahrhundertüberblick	Jahrhundert	Überblick
Jahrhundertübergang	Jahrhundert	Übergang
Jahrhundertunwetter	Jahrhundert	Unwetter
Jahrhundert-Unwort	Jahrhundert	Unwort
Jahrhundert-Utopie	Jahrhundert	Utopie
Jahrhundert-Veranstaltung	Jahrhundert	Veranstaltung
Jahrhundertvererber	Jahrhundert	Vererber
Jahrhundert-Verwüstung	Jahrhundert	Verwüstung
Jahrhundertvorstellung	Jahrhundert	Vorstellung
Jahrhundertwechsel	Jahrhundert	Wechsel
Jahrhundertwein	Jahrhundert	Wein
Jahrhundertwelle	Jahrhundert	Welle
Jahrhundert-Weltrekord	Jahrhundert	Weltrekord
Jahrhundertwenden	Jahrhundert	Wende
Jahrhundertwende-Society	Jahrhundertwende	Society
Jahrhundertwende-Zeit	Jahrhundertwende	Zeit
Jahrhundertwiederentdeckung	Jahrhundert	Wiederentdeckung
Jahrhundertwissenschaftler	Jahrhundert	Wissenschaftler
Jahrhundertwort	Jahrhundert	Wort
Jahrhundertzeitzeuge	Jahrhundert	Zeitzeuge
Jahrhundertzeugin	Jahrhundert	Zeugin
Jahrhundertziffer	Jahrhundert	Ziffer
Jahrhundertzug	Jahrhundert	Zug
Qualitätsbewusstsein	Qualität	Bewusstsein
Qualitätenlehre	Qualität	Lehre
Qualitätsabbau	Qualität	Abbau
Qualitätsabteilung	Qualität	Abteilung
Qualitätsaktie	Qualität	Aktie
Qualitäts-Andon-System	Qualitäts	Andonsystem
Qualitätsangelegenheit	Qualität	Angelegenheit
Qualitätsansatz	Qualität	Ansatz
Qualitäts-Arbeitsgruppe	Qualitäts	Arbeitsgruppe
Qualitätsarmatur	Qualität	Armatur
Qualitäts-Audit	Qualität	Audit
Qualitätsauditierung	Qualität	Auditierung
Qualitätsaussage	Qualität	Aussage
Qualitätsbaustein	Qualität	Baustein
Qualitätsbauweise	Qualität	Bauweise
Qualitätsbedenken	Qualität	Bedenken
Qualitätsbemessung	Qualität	Bemessung
Qualitätsbericht	Qualität	Bericht
Qualitätsbeschaffenheit	Qualität	Beschaffenheit
Qualitätsbewertungskriterium	Qualitätsbewertung	Kriterium
Qualitäts-Coach	Qualitäts	Coach
Qualitätsdrang	Qualität	Drang
Qualitätsdruck	Qualität	Druck
Qualitätsdübel	UNKNOWN	UNKNOWN
Qualitätsdumping	Qualität	Dumping
Qualitätsebene	Qualität	Ebene
Qualitätseffekt	Qualität	Effekt
Qualitätsentscheidung	Qualität	Entscheidung
Qualitätsent­wicklung	UNKNOWN	UNKNOWN
Qualitätsentwicklungsplan	Qualitätsentwicklung	Plan
Qualitätsentwicklungsprogramm	Qualitätsentwicklung	Programm
Qualitätsentwicklungssystem	Qualitätsentwicklung	System
Qualitätsertrag	Qualität	Ertrag
Qualitätserweiterung	Qualität	Erweiterung
Qualitäts-Export	Qualität	Export
Qualitätsfeuerwerk	Qualität	Feuerwerk
Qualitätsfilm	Qualität	Film
Qualitätsfleisch	Qualität	Fleisch
Qualitätsfliese	Qualität	Fliese
Qualitätsfluglinie	Qualität	Fluglinie
Qualitätsfonds	Qualität	Fond
Qualitätsförderung	Qualität	Förderung
Qualitätsformat	Qualität	Format
Qualitätsforscher	Qualität	Forscher
Qualitätsfoto	Qualität	Foto
Qualitätsfront	Qualität	Front
Qualitäts-Gang	Qualität	Gang
Qualitätsgeige	Qualität	Geige
Qualitätsgemeinschaft	Qualität	Gemeinschaft
Qualitätsgras	Qualität	Gras
Qualitätsgründung	Qualität	Gründung
Qualitätshandschuhe	Qualität	Handschuh
Qualitätshelm	Qualität	Helm
Qualitätshierarchie	Qualität	Hierarchie
Qualitätshonig	Qualität	Honig
Qualitäts-IATA-Linien-Gesellschaft	Qualitäts	IATA-liniengesellschaft
Qualitätsingenieur	Qualität	Ingenieur
Qualitätsinstitut	Qualität	Institut
Qualitätskatalog	Qualität	Katalog
Qualitäts-Kennzeichnung	Qualitäts	Kennzeichnung
Qualitätskonverter	Qualität	Konverter
Qualitätskopf	Qualität	Kopf
Qualitätskostengruppen	Qualität	Kostengruppe
Qualitätskostenstruktur	Qualität	Kostenstruktur
Qualitätskrise	Qualität	Krise
Qualitätskriterium	Qualität	Kriterium
Qualitätslabor	Qualität	Labor
Qualitätsladen	Qualität	Laden
Qualitätslevel	Qualität	Level
Qualitätslösung	Qualität	Lösung
Qualitätsmanagementagentur	Qualitätsmanagement	Agentur
Qualitätsmanagementfragen	Qualitätsmanagement	Frage
Qualitätsmanagementkonzept	Qualitätsmanagement	Konzept
Qualitätsmanagementprojekt	Qualitätsmanagement	Projekt
Qualitätsmanagementprozess	Qualitätsmanagement	Prozess
Qualitätsmanagementrichtlinie	Qualitätsmanagement	Richtlinie
Qualitätsmarathon	Qualität	Marathon
Qualitätsmargarine	Qualität	Margarine
Qualitätsmatratze	Qualität	Matratze
Qualitätsmesse	Qualität	Messe
Qualitäts-Messer	Qualität	Messer
Qualitätsmesssystem	Qualitätsmessung	System
Qualitätsmetzgerei	Qualität	Metzgerei
Qualitätsmetzger	Qualität	Metzger
Qualitäts-Mindeststandard	Qualität	Mindeststandard
Qualitäts-Minimalismus	Qualität	Minimalismus
Qualitätsmöbel	Qualität	Möbel
Qualitätsmodem	Qualität	Modem
Qualitätsmotor	Qualität	Motor
Qualitätsnachweis	Qualität	Nachweis
Qualitätspegel	Qualität	Pegel
Qualitätsphilosophie	Qualität	Philosophie
Qualitätsplanungs-Methode	Qualitätsplanung	Methode
Qualitätsprinzip	Qualität	Prinzip
Qualitätsprüfsystem	Qualitätsprüfung	System
Qualitätsprüfung	Qualität	Prüfung
Qualitätsradio	Qualität	Radio
Qualitätsrefugium	Qualität	Refugium
Qualitätsregelkreis	Qualität	Regelkreis
Qualitäts-Reise	Qualität	Reise
Qualitäts-Ritterzelt	Qualität	Ritterzelt
Qualitätsrucksack	Qualität	Rucksack
Qualitätsrückschlüsse	Qualität	Rückschluss
Qualitätssaat	Qualität	Saat
Qualitätssache	Qualität	Sache
Qualitätsschmiede	Qualität	Schmiede
Qualitätsschotter	Qualität	Schotter
Qualitätssenkung	Qualität	Senkung
Qualitätssessel	Qualität	Sessel
Qualitätssicherheitsüberwacher	Qualitätssicherheit	Überwacher
Qualitätssicherungsaufwand	Qualitätssicherung	Aufwand
Qualitätssicherungs-Institut	Qualitätssicherung	Institut
Qualitätssicherungslabor	Qualitätssicherung	Labor
Qualitätssicherungsstandard	Qualitätssicherung	Standard
Qualitätssicherungverfahren	Qualitätssicherung	Verfahren
Qualitätssignal	Qualität	Signal
Qualitätsspitze	Qualität	Spitze
Qualitätssprit	Qualität	Sprit
Qualitäts-Sprung	Qualität	Sprung
Qualitätsstandard	Qualität	Standard
Qualitäts-Störfaktor	Qualität	Störfaktor
Qualitätssturz	Qualität	Sturz
Qualitätssymbol	Qualität	Symbol
Qualitäts-Tageszeitung	Qualität	Tageszeitung
Qualitätstag	Qualität	Tag
Qualitätstester	Qualität	Tester
Qualitäts-Tipp	Qualität	Tipp
Qualitätstoren	Qualität	Tor
Qualitätstourismus	Qualität	Tourismus
Qualitätstrend	Qualität	Trend
Qualitätstropfen	Qualität	Tropfen
Qualitätsüberblick	Qualität	Überblick
Qualitäts-Unterricht	Qualität	Unterricht
Qualitätsurlaubsland	Qualität	Urlaubsland
Qualitätsverbesserung	Qualität	Verbesserung
Qualitätsverschiebung	Qualität	Verschiebung
Qualitätsverschlankung	Qualität	Verschlankung
Qualitätsversprechen	Qualität	Versprechen
Qualitätsvieh	Qualität	Vieh
Qualitätsvögel	Qualität	Vogel
Qualitätswanderweg	Qualität	Wanderweg
Qualitätswäsche	Qualität	Wäsche
Qualitätswasserbett	Qualität	Wasserbett
Qualitätsweg	Qualität	Weg
Qualitätsweingegend	Qualität	Weingegend
Qualitätsweingut	Qualität	Weingut
Qualitätswein	Qualität	Wein
Qualitätswein-Konsument	Qualitätswein	Konsument
Qualitätsweinproduktion	Qualitätswein	Produktion
Qualitätsweizenanbau	Qualitätsweizen	Anbau
Qualitätswerft	Qualität	Werft
Qualitätswerke	Qualität	Werk
Qualitätswerkstatt	Qualität	Werkstatt
Qualitätswerkstoff	Qualität	Werkstoff
Qualitätswerkzeug	Qualität	Werkzeug
Qualitätswert	Qualität	Wert
Qualitätswesen	Qualität	Wesen
Qualitätswettbewerb	Qualität	Wettbewerb
Qualitätswettstreit	Qualität	Wettstreit
Qualitätswinzer	Qualität	Winzer
Qualitätswissenschaft	Qualität	Wissenschaft
Qualitätswitze	Qualität	Witz
Qualitätswoche	Qualität	Woche
Qualitätsworkshop	Qualität	Workshop
Qualitätswünsche	Qualität	Wunsch
Qualitätswurf	Qualität	Wurf
Qualitätsystem	Qualität	System
Qualitätszahlen	Qualität	Zahl
Qualitäts­zeichen	Qualität	Zeichen
Qualitätszeichenpolitik	Qualitätszeichen	Politik
Qualitätszeitalter	Qualität	Zeitalter
Qualitäts-Zeitung	Qualität	Zeitung
Qualitätszeitzone	Qualitätszeit	Zone
Qualitätszenit	Qualität	Zenit
Qualitätszentrum	Qualität	Zentrum
Qualitätszertifikat	Qualität	Zertifikat
Qualitätszertifizierung	Qualität	Zertifizierung
Qualitätszielgruppe	Qualität	Zielgruppe
Qualitätszielkonzept	Qualitätsziel	Konzept
Qualitätszielüberschreitung	Qualitätsziel	Überschreitung
Qualitätszielverordnung	Qualitätsziel	Verordnung
Qualitätszigarette	Qualität	Zigarette
Qualitätszirkelbeauftragter	Qualitätszirkel	Beauftragter
Qualitätszirkelprojekt	Qualitätszirkel	Projekt
Qualitätszirkelsitzung	Qualitätszirkel	Sitzung
Qualitätszirkel-Sprecher	Qualitätszirkel	Sprecher
Qualitätszirkeltreffen	Qualitätszirkel	Treffen
Qualitätszugang	Qualität	Zugang
Qualitätszugewinn	Qualität	Zugewinn
Qualitätszug	Qualität	Zug
Qualitätszusage	Qualität	Zusage
Qualitätszuschauer	Qualität	Zuschauer
Qualitätszuschlag	Qualität	Zuschlag
Qualitätszustandsbericht	Qualität	Zustandsbericht
Qualitätszustellung	Qualität	Zustellung
Qualitätszutat	Qualität	Zutat
Qualitätszuwachs	Qualität	Zuwachs
Qualitätszweifel	Qualität	Zweifel
Qualitätszweig	Qualität	Zweig
Qualitäturteil	Qualität	Urteil
Qualitätswein	Qualität	Wein
Schweineabgase	Schwein	Abgas
Schweineafter	Schwein	After
Schweine-Albtraum	Schwein	Albtraum
Schweinearschloch	Schwein	Arschloch
Schweinearsch	Schwein	Arsch
Schweineausbruch	Schwein	Ausbruch
Schweineausstellung	Schwein	Ausstellung
Schweinebammel	Schwein	Bammel
Schweinebändel	Schwein	Bändel
Schweinebaron	Schwein	Baron
Schweine-Bauchspeicheldrüse	Schwein	Bauchspeicheldrüse
Schweinebefreiung	Schwein	Befreiung
Schweinebein	Schwein	Bein
Schweinebesamung	Schwein	Besamung
Schweinebesatz	Schwein	Besatz
Schweinebesitzer	Schwein	Besitzer
Schweinebestand	Schwein	Bestand
Schweinebetrieb	Schwein	Betrieb
Schweine-Bild	Schweine	Bild
Schweine-Bioprothese	Schweine	Bioprothese
Schweineblut	Schwein	Blut
Schweineborstenpinsel	Schweineborste	Pinsel
Schweinebraten	Schwein	Braten
Schweinebräutigam	Schwein	Bräutigam
Schweinebrett	Schwein	Brett
Schweinebrust	Schwein	Brust
Schweinecollagen	Schwein	Collage
Schweinecomix	Schwein	Comix
Schweine-Dasein	Schwein	Dasein
Schweinedatenbank	Schwein	Datenbank
Schweinedickdarm	Schwein	Dickdarm
Schweinediplom	Schwein	Diplom
Schweinedomestikation	Schwein	Domestikation
Schweinedrama	Schwein	Drama
Schweinedusche	Schwein	Dusche
Schweine-Eierstöcke	Schwein	Eierstock
Schweine-Eizelle	Schwein	Eizelle
Schweineembryo	Schwein	Embryo
Schweineerwerb	Schwein	erwerben
Schweineerzeugerring	Schweineerzeuger	Ring
Schweineerzeuger	Schwein	Erzeuger
Schweineesser	Schwein	Esser
Schweine-Extrakt	Schwein	Extrakt
Schweinefabrik	Schwein	Fabrik
Schweinefamilie	Schwein	Familie
Schweinefan	Schwein	Fan
Schweinefiletscheibe	Schweinefilet	Scheibe
Schweinefleischeinlage	Schweinefleisch	Einlage
Schweinefleisch-Erzeugung	Schweinefleisch	Erzeugung
Schweinefleischexporteur	Schweinefleisch	Exporteur
Schweinefleisch-Fan	Schweinefleisch	Fan
Schweinefleisch	Schwein	Fleisch
Schweinefleisch-Verbot	Schweinefleisch	Verbot
Schweineflüsterer	Schwein	Flüsterer
Schweinefötus	Schwein	Fötus
Schweinefrass	Schwein	Fraß
Schweinefrau	Schwein	Frau
Schweinefüße	Schwein	Fuß
Schweinefutter	Schwein	Futter
Schweinegedärm	Schwein	Gedärm
Schweinegedicht	Schwein	Gedicht
Schweinegehacktes	Schwein	hacken
Schweinegehirn	Schwein	Gehirn
Schweinegeld	Schwein	Geld
Schweinegeschichte	Schwein	Geschichte
Schweinegestalt	Schwein	Gestalt
Schweine-Gewebe	Schweine	Gewebe
Schweinegitter	Schwein	Gitter
Schweine-Glück	Schweine	Glück
Schweinegroßanlage	Schwein	Großanlage
Schweine-Gulaschs	Schweine	Gulasch
Schweinegülle	Schwein	Gülle
Schweinehaare	Schwein	Haar
Schweinehalle	Schwein	Halle
Schweinehalter	Schwein	Halter
Schweinehaltung	Schwein	Haltung
Schweinehändler	Schwein	Händler
Schweinehäuschen	Schwein	Häuschen
Schweinehaut	Schwein	Haut
Schweinehaxe	Schwein	Haxe
Schweinehehälfte	Schwein	Hälfte
Schweineherz	Schwein	Herz
Schweinehirte	Schwein	Hirte
Schweinehölle	Schwein	Hölle
Schweinehund-Alarm	Schweinehund	Alarm
Schweinehüters	Schwein	Hüter
Schweineidyll	Schwein	Idyll
Schweine-Illustrationen	Schweine	Illustration
Schweineinfluenza	Schwein	Influenza
Schweineinnereien	Schwein	Innerei
Schweine-Insel	Schweine	Insel
Schweineintensivhaltung	Schwein	Intensivhaltung
Schweinejunges	Schwein	Junges
Schweinekadaver	Schwein	Kadaver
Schweinekatapult	Schwein	Katapult
Schweinekauf	Schwein	Kauf
Schweinekennzeichnung	Schwein	Kennzeichnung
Schweinekiefer	Schwein	Kiefer
Schweineknecht	Schwein	Knecht
Schweineknorpel	Schwein	Knorpel
Schweinekoben	Scheine	Koben
Schweinekober	Schwein	Kober
Schweinekolonie	Schwein	Kolonie
Schweinekontrakt	Schwein	Kontrakt
Schweinekostüme	Schwein	Kostüm
Schweinekottlet	Schwein	Kotelett
Schweinekreatur	Schwein	Kreatur
Schweinekrieg	Schwein	Krieg
Schweinelappen	Schwein	Lappen
Schweinelendchen	Schwein	Lendchen
Schweine-Lexikon	Schweine	Lexikon
Schweinelippe	Schwein	Lippe
Schweinelunge	Schwein	Lunge
Schweinemagen	Schwein	Magen
Schweinemann	Schwein	Mann
Schweinemark	Schwein	Mark
Schweinemarkt	Schwein	Markt
Schweinemaske	Schwein	Maske
Schweinemastanlage	Schweinemast	Anlage
Schweinemastbtrieb	Schweinemast	Betrieb
Schweine-Mäster	Schweine	Mäster
Schweine-Mastplätze	Schweine	Mastplatz
Schweinemast-Zentren	Schweinemast	Zentrum
Schweinemäuler	Schwein	Maul
Schweinemedaillon	Schwein	Medaillon
Schweinemedien	Schwein	Medium
Schweinemedizin	Schwein	Medizin
Schweinemetzger	Schwein	Metzger
Schweinemilch	Schwein	Milch
Schweineminutensteak	Schwein	Minutensteak
Schweinemotiv	Schwein	Motiv
Schweinemumie	Schwein	Mumie
Schweinemund	Schwein	Mund
Schweinemuseum	Schwein	Museum
Schweinenase	Schwein	Nase
Schweinenummer	Schwein	Nummer
Schweineobst	Schwein	Obst
Schweineorgan	Schwein	Organ
Schweineorgel	Schwein	Orgel
Schweineorgie	Schwein	Orgie
Schweinepaar	Schwein	Paar
Schweinepanik	Schwein	Panik
Schweineparadies	Schwein	Paradies
Schweinepascha	Schwein	Pascha
Schweinepest	Schwein	Pest
Schweinepferch	Schwein	Pferch
Schweinepfote	Schwein	Pfote
Schweinepraxis	Schwein	Praxis
Schweinepreisverfall	Schweinepreis	Verfall
Schweinepriester	Schwein	Priester
Schweineprodukt	Schwein	Produkt
Schweinequäler	Schwein	Quäler
Schweinereiter	Schwein	Reiter
Schweinerippe	Schwein	Rippe
Schweineritt	Schwein	Ritt
Schweineröllchen	Schwein	Röllchen
Schweinerotte	Schwein	Rotte
Schweinerücken	Schwein	Rücken
Schweinerüssel	Schwein	Rüssel
Schweinesand	Schwein	Sand
Schweineschäufele	Schwein	Schäufele
Schweineschlächterei	Schwein	Schlächterei
Schweineschlächter	Schwein	Schlächter
Schweineschlegel	Schwein	Schlegel
Schweineschwänzel	Schweine	Schwänzchen
Schweineschwanzstechen	Schweineschwanz	Stechen
Schweineschwartenchips	Schweineschwarte	Chip
Schweineschwarten	Schwein	Schwarte
Schweinesegment	Schwein	Segment
Schweineseite	Schwein	Seite
Schweinesilo	Schwein	Silo
Schweineskandal	Schwein	Skandal
Schweinesorte	Schwein	Sorte
Schweine-Speck	Schwein	Speck
Schweinespezialberater	Schwein	Spezialberater
Schweine-Spiel	Schweine	Spiel
Schweine-Stammtisch	Schweine	Stammtisch
Schweine-Suhlfest	Schweine	Suhlfest
Schweinetanzmelodie	Schweinetanz	Melodie
Schweinetanz	Schwein	Tanz
Schweineteilen	Schwein	Teil
Schweinetötung	Schwein	Tötung
Schweinetransports	Schwein	Transport
Schweinetrog	Schwein	Trog
Schweinevideo	Schwein	Video
Schweinewaden	Schwein	Wade
Schweinewarzen	Schwein	Warze
Schweineweide	Schwein	Weide
Schweine-Weltmeisterschaft	Schweine	Weltmeisterschaft
Schweinewürfel	Schwein	Würfel
Schweinewürschte	Schwein	Wurst
Schweinewürste	Schwein	Wurst
Schweinezahl	Schwein	Zahl
Schweinezählungen	Schwein	zählung
Schweinezählung	Schwein	zählung
Schweinezahn	Schwein	Zahn
Schweinezelle	Schwein	Zelle
Schweinezins	Schwein	Zins
Schweinezuchtorganisation	Schweinezucht	Organisation
Schweinezüchtung	Schwein	Züchtung
Schweine-Zwerge	Schwein	Zwerg
Spitzenakteur	Spitze	Akteur
Spitzenalternative	Spitze	Alternative
Spitzenanalyst	Spitze	Analyst
Spitzenanalytik	Spitze	Analytik
Spitzenanlage	Spitze	Anlage
Spitzen-Arbeitgeberverband	Spitzen	Arbeitgeberverband
SPITZENARCHITEKTUR	Spitze	Architektur
Spitzen-Atomwissenschaftler	Spitze	Atomwissenschaftler
Spitzenauslese	Spitze	Auslese
Spitzenausstellung	Spitze	Ausstellung
Spitzenbariton	Spitze	Bariton
Spitzen-Beamter	Spitzen	Beamte
Spitzenbeamtin	Spitze	Beamtin
Spitzenbeanspruchung	Spitze	Beanspruchung
Spitzenbegabung	Spitze	Begabung
Spitzenbeispiel	Spitze	Beispiel
Spitzen-Belegungsrate	Spitze	Bbelegungsrate
Spitzenbereich	Spitze	Bereich
Spitzenbergsteiger	Spitze	Bergsteiger
Spitzenberufung	Spitze	Berufung
Spitzenbesatz	Spitze	Besatz
Spitzenblatt	Spitze	Blatt
Spitzenboot	Spitze	Boot
Spitzenborte	Spitze	Borte
Spitzen-Damen-Slip	Spitzen	Damenslip
Spitzendarbietung	Spitze	Darbietung
Spitzendecke	Spitze	Decke
Spitzendoppel	Spitze	Doppel
Spitzendownhiller	Spitze	Downhiller
Spitzenedition	Spitze	Edition
Spitzeneffekt	Spitze	Effekt
Spitzeneinheit	Spitze	Einheit
Spitzen-Entertainer	Spitzen	Entertainer
Spitzenentwicklung	Spitze	Entwicklung
Spitzenereignis	Spitze	Ereignis
Spitzen-Erinnerung	Spitzen	Erinnerung
Spitzenetage	Spitze	Etage
Spitzenfachverband	Spitze	Fachverband
Spitzen-Fahrer	Spitzen	Fahrer
Spitzenfahrzeug	Spitze	Fahrzeug
Spitzen-Fakultät	Spitzen	Fakultät
Spitzenfirma	Spitze	Firma
Spitzen-Flightcase	Spitze	Flightcase
Spitzen	Spitz	Spitze
Spitzenformulierung	Spitze	Formulierung
Spitzenforscher	Spitze	Forscher
Spitzen-Forschungsergebnis	Spitzen	Forschungsergebnis
Spitzenforum	Spitze	Forum
Spitzen-Fotograf	Spitzen	Fotograf
Spitzenfunktionär	Spitze	Funktionär
Spitzengefühl	Spitze	Gefühl
Spitzengenossin	Spitze	Genossin
Spitzen-Geräte	Spitzen	Gerät
Spitzengliederung	Spitze	Gliederung
Spitzengolf	Spitze	Golf
Spitzengrafik	Spitze	Grafik
Spitzengremium	Spitze	Gremium
Spitzen-Handballteam	Spitzen	Handballteam
Spitzen-Hardware	Spitzen	Hardware
Spitzenhochschule	Spitze	Hochschule
Spitzenholz	Spitze	Holz
Spitzenimpulsleistung	Spitzenimpuls	Leistung
Spitzenintensität	Spitze	Intensität
Spitzenjazz	Spitze	Jazz
Spitzenjournal	Spitze	Journal
Spitzenjunge	Spitze	Junge
Spitzenkader	Spitze	Kader
Spitzenkamerad	Spitze	Kamerad
Spitzenkämpferin	Spitze	Kämpferin
Spitzenkandidatin	Spitze	Kandidatin
Spitzenkanon	Spitze	Kanon
Spitzenkeramik	Spitze	Keramik
Spitzenklinik	Spitze	Klinik
Spitzenklöpplerin	Spitze	Klöpplerin
Spitzen-Know-how	Spitze	Know-How
Spitzen-Know-How	Spitze	Know-How
Spitzenkoch	Spitze	Koch
Spitzenkollektion	Spitze	Kollektion
Spitzenkomödie	Spitze	Komödie
Spitzenkompetenz	Spitze	Kompetenz
Spitzen-Komponist	Spitzen	Komponist
Spitzenkonditorei	Spitze	Konditorei
Spitzenkonservierungstechnologie	Spitze	Konservierungstechnologie
Spitzenkosten	Spitze	Kosten
Spitzen-Kraft	Spitzen	Kraft
Spitzenkühler	Spitze	Kühler
Spitzenkulturverband	Spitze	Kulturverband
Spitzen-Lamm	Spitzen	Lamm
Spitzenlangläuferin	Spitze	Langläuferin
Spitzenlaser	Spitze	Laser
Spitzenläufer	Spitze	Läufer
Spitzenleistung	Spitze	Leistung
Spitzenlicht	Spitze	Licht
Spitzenlösung	Spitze	Lösung
Spitzen-Managerin	Spitzen	Managerin
Spitzenmandat	Spitze	Mandat
Spitzen-Mann	Spitzen	Mann
Spitzenmarke	Spitze	Marke
Spitzenmassage	Spitze	Massage
Spitzenmathematik	Spitze	Mathematik
Spitzenmenge	Spitze	Menge
Spitzen-Moderator	Spitzen	Moderator
Spitzenmuseum	Spitze	Museum
Spitzennews	Spitze	News
Spitzenöl	Spitze	Öl
Spitzenönologe	Spitze	Önologe
Spitzenorganisa­tion	Spitze	Organisation
Spitzenorganist	Spitze	Organist
Spitzenpart	Spitze	Part
Spitzenparzelle	Spitze	Parzelle
Spitzenpferd	Spitze	Pferd
Spitzenplatz	Spitze	Platz
Spitzen-Politikern	Spitzen	Politiker
Spitzenpolizist	Spitze	Polizist
Spitzenpotential	Spitze	Potential
Spitzen-Potenzial	Spitzen	Potenzial
Spitzenpower	Spitze	Power
Spitzen-Preis	Spitzen	Preis
Spitzenprofessor	Spitze	Professor
Spitzenprogramm	Spitze	Programm
Spitzenpro	Spitze	Pro
Spitzenpulk	Spitze	Pulk
Spitzenquartett	Spitze	Quartett
Spitzenradius	Spitze	Radius
Spitzenrating	Spitze	Rating
Spitzenreferee	Spitze	Referee
Spitzenrefinanzierungssatz	Spitze	Refinanzierungssatz
Spitzenregulator	Spitze	Regulator
Spitzenreisezeit	Spitze	Reisezeit
Spitzenreiter	Spitze	Reiter
Spitzenring	Spitze	Ring
Spitzenrock	Spitze	Rock
Spitzen-Rollenspiel	Spitzen	Rollenspiel
Spitzenrosette	Spitze	Rosette
Spitzen-Roter	Spitzen	Roter
Spitzenrotwein	Spitze	Rotwein
Spitzenrunde	Spitze	Runde
Spitzenrüsche	Spitze	Rüsche
Spitzen-Schauspieltalent	Spitze	Schauspieltalent
Spitzenscheibe	Spitze	Scheibe
Spitzen-Schiedsrichterin	Spitzen	Schiedsrichterin
Spitzen-Schiedsrichter	Spitzen	Schiedsrichter
Spitzen-Schneeparty	Spitzen	Schneeparty
Spitzenschülerin	Spitze	Schülerin
Spitzenschwester	Spitze	Schwester
Spitzensextett	Spitze	Sextett
Spitzenshirt	Spitze	Shirt
Spitzensignal	Spitze	Signal
Spitzensingle	Spitze	Single
Spitzensite	Spitze	Site
Spitzen-Sommer-Mitsing-Schunkel-Tequila	Spitzen	Sommer-Mitsing-Schunkel-Tequila
Spitzen-Spieler	Spitze	Spieler
Spitzenspiel	Spitze	Spiel
Spitzenspion	Spitze	Spion
Spitzensportler	Spitze	Sportler
Spitzenspringreiter	Spitze	Springreiter
Spitzensprinterin	Spitze	Sprinterin
Spitzenstern	Spitze	Stern
Spitzenstickerei	Spitze	Stickerei
Spitzenstreifen	Spitze	Streifen
Spitzenstrombedarf	Spitze	Strombedarf
Spitzenstrom	Spitze	Strom
Spitzentauglichkeit	Spitze	Tauglichkeit
Spitzentech­nologie	Spitze	Technologie
Spitzentechnologie	Spitze	Technologie
Spitzentee	Spitze	Tee
Spitzentennis	Spitze	Tennis
Spitzen-Tennis	Spitze	Tennis
Spitzentermin	Spitze	Termin
Spitzen-Treffen	Spitzen	Treffen
Spitzentropfen	Spitze	Tropfen
Spitzentruppe	Spitze	Truppe
Spitzenumhang	Spitze	Umhang
Spitzen-Universität	Spitzen	Universität
Spitzen-Unparteiischer	Spitzen	Unparteiischer
Spitzen-UN-Polizist	Spitzen	UN-Polizist
Spitzenunternehmen	Spitze	Unternehmen
Spitzenurlaub	Spitze	Urlaub
Spitzen­verband	Spitze	Verband
Spitzenverband	Spitze	Verband
Spitzenverbindung	Spitze	Verbindung
Spitzen-Verbrauch	Spitzen	Verbrauch
Spitzenverdiener	Spitze	Verdiener
Spitzenverein	Spitze	Verein
Spitzenverpflegung	Spitze	Verpflegung
Spitzenvertrag	Spitze	Vertrag
Spitzenvertreter	Spitze	Vertreter
Spitzenvorbild	Spitze	Vorbild
Spitzenvotum	Spitze	Votum
Spitzenwaffe	Spitze	Waffe
Spitzenwanderung	Spitze	Wanderung
Spitzenweg	Spitze	Weg
Spitzen-Weißwein	Spitzen	Weißwein
Spitzenweite	Spitze	Weite
Spitzenwert	Spitze	Wert
Spitzenwissenschaftlerin	Spitze	Wissenschaftlerin
Spitzen-Wissenschaftler	Spitzen	Wissenschaftler
Spitzenzahl	Spitze	Zahl
Spitzenzentrum	Spitze	Zentrum
Spitzen-Zinssatz	Spitzen	Zinssatz
Spitzenzitat	Spitze	Zitat
Traum-Abbild	Traum	Abbild
Traum-Abitur	Traum	Abitur
Traum-Abschluss	Traum	Abschluss
Traum-Abtastung	Traum	Abtastung
Traum-Abwehr	Traum	Abwehr
Traum-Agentur	Traum	Agentur
Traum-Aktion	Traum	Aktion
Traumaktivität	Traum	Aktivität
Traum-Aktivurlaub	Traum	Aktivurlaub
Traumambiente	Traum	Ambiente
Traumanblick	Traum	Anblick
Traumangestellter	Traum	Angestellte
Traumaquarium	Traum	Aquarium
Traumarbeiterin	Traum	Arbeiterin
Traum-Arbeitgeber	Traum	Arbeitgeber
Traum-Arbeit	Traum	Arbeit
Traumarena	Traum	Arena
Traumauffassung	Traum	Auffassung
Traumaufnahme	Traum	Aufnahme
Traumaugen	Traum	Auge
Traumausbildung	Traum	Ausbildung
Traumauslegung	Traum	Auslegung
Traum-Auslotung	Traum	Auslotung
Traumausrüstung	Traum	Ausrüstung
Traum-Ballerina	Traum	Ballerina
Traumbegriff	Traum	Begriff
Traumbeschäftigung	Traum	Beschäftigung
Traumbewegung	Traum	Bewegung
Traum-Bewußtsein	Traum	Bewusstsein
Traum-Bike	Traum	Bike
Traumblatt	Traum	Blatt
Traumblau	Traum	Blau
Traumblicke	Traum	Blick
Traumbolide	Traum	Bolide
Traumboot	Traum	Boot
Traumbuch	Traum	Buch
Traumbündnis	Traum	Bündnis
Traumbusen	Traum	Busen
Traum-Chef	Traum	Chef
Traumcuvée	Traum	Cuvée
Traumdeuter	Traum	Deuter
Traumdichtung	Traum	Dichtung
Traumdose	Traum	Dose
Traumduo	Traum	Duo
Traumecke	Traum	Ecke
Traum-Ego	Traum	Ego
Traum-Ehe	Traum	Ehe
Traumeinschaltquote	Traum	Einschaltquote
Traum-Eintopf	Traum	Eintopf
Traumelefant	Traum	Elefant
Traumentschlüsselung	Traum	Entschlüsselung
Traumentstellung	Traum	Entstellung
Traumepisode	Traum	Episode
Traumerzählung	Traum	Erzählung
Traumerzeugung	Traum	Erzeugung
Traumexperte	Traum	Experte
Traumexpreß	Traum	Express
Traumfalle	Traum	Falle
Traumfänger	Traum	Fänger
Traumfang	Traum	Fang
Traum-Figur	Traum	Figur
Traumfilm	Traum	Film
Traum-Flugpreis	Traum	Flugpreis
Traumflug	Traum	Flug
Traum-Frau	Traum	Frau
Traumfreistoß	Traum	Freistoß
Traum-Freizeitinsel	Traum	Freizeitinsel
Traumfrühlingstag	Traum	Frühlingstag
Traumfußballer	Traum	Fußballer
Traumgarten	Traum	Garten
Traumgebäck	Traum	Gebäck
Traumgebilde	Traum	Gebilde
Traumgegend	Traum	Gegend
Traumgelaber	Traum	labern
Traum-Geländewagen	Traum	Geländewagen
Traumgeschichte	Traum	Geschichte
Traumgewirk	Traum	Gewirk
Traumgitarre	Traum	Gitarre
Traumgraphik	Traum	Graphik
Traumgrundstück	Traum	Grundstück
Traumhand	Traum	Hand
Traumhandy	Traum	Handy
Traumhaus	Traum	Haus
Traumhöhe	Traum	Höhe
Traum-Hotel	Traum	Hotel
Traum-Hündin	Traum	Hündin
Traumideal	Traum	Ideal
Traumillusion	Traum	Illusion
Traumimago	Traum	Imago
Trauminkarnation	Traum	Inkarnation
Traum-Insel	Traum	Insel
Traum-Interview-Partner	Traum	Interviewpartner
Traumjahr	Traum	Jahr
Traumkater	Traum	Kater
Traumknutscherei	Traum	Knutscherei
Traumkobold	Traum	Kobold
Traumkompositum	Traum	Kompositum
Traumkontinent	Traum	Kontinent
Traumkonzert	Traum	Konzert
Traumkuchen	Traum	Kuchen
Traumkünstlerin	Traum	Künstlerin
Traumkurs	Traum	Kurs
Traumlaboratorium	Traum	Laboratorium
Traumlandgerät	Traumland	Gerät
Traum-Lexikon	Traum	Lexikon
Traumlinie	Traum	Linie
Traumlohn	Traum	Lohn
Traumlos	Traum	Los
Traummacher	Traum	Macher
Traummädchen	Traum	Mädchen
Traummass	Traum	Maß
Traummaus	Traum	Maus
Traum-Meister	Traum	Meister
Traummembran	Traum	Membran
Traummotiv	Traum	Motiv
Traummotor	Traum	Motor
Traummühle	Traum	Mühle
Traumnummer	Traum	Nummer
Traumoper	Traum	Oper
Traumorten	Traum	Ort
Traumpark	Traum	Park
Traumpartie	Traum	Partie
Traum-Performance	Traum	Performance
Traumpfad	Traum	Pfad
Traumpopsong	Traum	Popsong
Traumprojekt	Traum	Projekt
Traum-Punkband	Traum	Punkband
Traum-Puzzle	Traum	Puzzle
Traumquote	Traum	Quote
Traumrasen	Traum	Rasen
Traum-Realität	Traum	Realität
Traumregal	Traum	Regal
Traumregierung	Traum	Regierung
Traumregisseur	Traum	Regisseur
Traum-Reihe	Traum	Reihe
Traumreiseland	Traum	Reiseland
Traum-Reise	Traum	Reise
Traumrolle	Traum	Rolle
Traumsaat	Traum	Saat
Traumschaum	Traum	Schaum
Traumschema	Traum	Schema
Traumschilderung	Traum	Schilderung
Traumschlag	Traum	Schlag
Traumschlange	Traum	Schlange
Traumschuluniform	Traum	Schuluniform
Traumseil	Traum	Seil
Traum-Semester	Traum	Semester
Traumserie	Traum	Serie
Traumservice	Traum	Service
Traumshooting	Traum	Shooting
Traumsiebs	Traum	Sieb
Traumsofa	Traum	Sofa
Traumsphäre	Traum	Sphäre
Traumspringer	Traum	Springer
Traumstadion	Traum	Stadion
Traumsteins	Traum	Stein
Traum-Stele	Traum	Stele
Traumstelle	Traum	Stelle
Traumstory	Traum	Story
Traumstrand	Traum	Strand
Traumstrauß	Traum	Strauß
Traumstücke	Traum	Stück
Traumsuse	Traum	Suse
Traumsymbol	Traum	Symbol
Traumszenario	Traum	Szenario
Traumtagebuch	Traum	Tagebuch
Traumtänzerei	Traum	Tänzerei
Traumtänzer	Traum	Tänzer
Traumtechnik	Traum	Technik
Traum-Theater	Traum	Theater
Traumthematik	Traum	Thematik
Traumtheoretiker	Traum	Theoretiker
Traumtherapien	Traum	Therapie
Traumthese	Traum	These
Traumtiefe	Traum	Tiefe
Traumtrip	Traum	Trip
Traum-Tropeninsel	Traum	Tropeninsel
Traumultra	Traum	Ultra
Traumuniversum	Traum	Universum
Traumunsinn	Traum	Unsinn
Traumursache	Traum	Ursache
Traumvariation	Traum	Variation
Traumveranda	Traum	Veranda
Traumverkäufer	Traum	Verkäufer
Traumvers	Traum	Vers
Traum-Vocals	Traum	Vocals
Traumwagen	Traum	Wagen
Traum-Wald	Traum	Wald
Traumwandlerin	Traum	Wandlerin
Traumwäscherei	Traum	Wäscherei
Traumweinbar	Traum	Weinbar
Traumwein	Traum	Wein
Traumwelt	Traum	Welt
Traumwochenende	Traum	Wochenende
Traumwölkchen	Traum	Wölkchen
Traum-Yoga	Traum	Yoga
Traumzahl	Traum	Zahl
Traumzensur	Traum	Zensur
Traumzentrum	Traum	Zentrum
Traumzins	Traum	Zins
