Bilderbuchabsturz	Bilderbuch	Ideal	Y
Bilderbuchabteilung	Bilderbuch	Buch	N
Bilderbuchadaption	Bilderbuch	Buch	N
Bilderbuchalter	Bilderbuch	Buch	N
Bilderbuch-Altstadt	Bilderbuch	Ideal	Y
Bilderbuch-Amerikaner	Bilderbuch	Ideal	Y
Bilderbuchangriff	Bilderbuch	Ideal	Y
Bilderbuchanschauer	Bilderbuch	Buch	N
Bilderbuch-Anwesen	Bilderbuch	Ideal	Y
Bilderbuchaufenthalt	Bilderbuch	Ideal	Y
Bilderbuchauflage	Bilderbuch	Buch	N
Bilderbuchauftakt	Bilderbuch	Ideal	Y
Bilderbuch-Ausleihe	Bilderbuch	Buch	N
Bilderbuchauslese	Bilderbuch	Buch	N
Bilderbuch-Ausstellung	Bilderbuch	Buch	N
Bilderbuchauswahl	Bilderbuch	Buch	N
Bilderbuchautorin	Bilderbuch	Buch	N
Bilderbuchbabe	Bilderbuch	Ideal	Y
Bilderbuchband	Bilderbuch	Buch	N
Bilderbuch-Bär	Bilderbuch	Buch	N
Bilderbuch-Bauchladentheater	Bilderbuch	Ideal	Y
Bilderbuchbauer	Bilderbuch	Ideal	Y
Bilderbuch-Bayern	Bilderbuch	Ideal	Y
Bilderbuchbereich	Bilderbuch	Buch	N
Bilderbuchbestand	Bilderbuch	Buch	N
Bilderbuch-Bestseller	Bilderbuch	Buch	N
Bilderbuchbetrachtung	Bilderbuch	Buch	N
Bilderbuchbetrieb	Bilderbuch	Ideal	Y
Bilderbuchbibliothek	Bilderbuch	Buch	N
Bilderbuchbiographie	Bilderbuch	Ideal	Y
Bilderbuchblatt	Bilderbuch	Buch	N
Bilderbuch-Blitzstart	Bilderbuch	Ideal	Y
Bilderbuchblonde	Bilderbuch	Ideal	Y
Bilderbuch-Blondine	Bilderbuch	Ideal	Y
Bilderbuch-Blüte	Bilderbuch	Ideal	Y
Bilderbuch-Bohème	Bilderbuch	Ideal	Y
Bilderbuchbonze	Bilderbuch	Ideal	Y
Bilderbuchbörse	Bilderbuch	Buch	N
Bilderbuch-Bürger	Bilderbuch	Ideal	Y
Bilderbuchburg	Bilderbuch	Ideal	Y
Bilderbuchbutler	Bilderbuch	Ideal	Y
Bilderbuch-Chaletdorf	Bilderbuch	Ideal	Y
Bilderbuch-Countdown	Bilderbuch	Ideal	Y
Bilderbuchdasein	Bilderbuch	Ideal	Y
Bilderbuchdebüt	Bilderbuch	Ideal	Y
Bilderbuchdirigenten	Bilderbuch	Ideal	Y
Bilderbuchdorf	Bilderbuch	Ideal	Y
Bilderbuchdüne	Bilderbuch	Ideal	Y
Bilderbuchecke	Bilderbuch	Ideal	Y
Bilderbuch-Edelmut	Bilderbuch	Ideal	Y
Bilderbuch-Effekt	Bilderbuch	Buch	N
Bilderbuch-Ehefrau	Bilderbuch	Ideal	Y
Bilderbuch-Ehepartner	Bilderbuch	Ideal	Y
Bilderbuch-Einstand	Bilderbuch	Ideal	Y
Bilderbuch-Engländer	Bilderbuch	Ideal	Y
Bilderbuchepisode	Bilderbuch	Ideal	Y
Bilderbucherarbeitung	Bilderbuch	Buch	N
Bilderbuch-Erfolgsstory	Bilderbuch	Ideal	Y
Bilderbuchergebnis	Bilderbuch	Ideal	Y
Bilderbuch-Erzählung	Bilderbuch	Buch	N
Bilderbuch-Eskalation	Bilderbuch	Ideal	Y
Bilderbuchfamilie	Bilderbuch	Ideal	Y
Bilderbuch-Familienvater	Bilderbuch	Ideal	Y
Bilderbuch-Farmer	Bilderbuch	Ideal	Y
Bilderbuchfassung	Bilderbuch	Buch	N
Bilderbuchfjord	Bilderbuch	Ideal	Y
Bilderbuch-Flugwetter	Bilderbuch	Ideal	Y
Bilderbuchforschung	Bilderbuch	Buch	N
Bilderbuch-Fuß	Bilderbuch	Ideal	Y
Bilderbuchgangster	Bilderbuch	Ideal	Y
Bilderbuchganove	Bilderbuch	Ideal	Y
Bilderbuchgeburt	Bilderbuch	Ideal	Y
Bilderbuch-Genuß	Bilderbuch	Buch	N
Bilderbuch-Geschichte	Bilderbuch	Buch	N
Bilderbuch-Gestaltung	Bilderbuch	Buch	N
Bilderbuchgrafik	Bilderbuch	Buch	N
Bilderbuch-Großformat	Bilderbuch	Buch	N
Bilderbuchgrundstück	Bilderbuch	Ideal	Y
Bilderbuch-Hafen	Bilderbuch	Ideal	Y
Bilderbuchhäftling	Bilderbuch	Ideal	Y
Bilderbuchhalbmond	Bilderbuch	Ideal	Y
Bilderbuchhändler	Bilderbuch	Buch	N
Bilderbuchharmonie	Bilderbuch	Ideal	Y
Bilderbuchheldin	Bilderbuch	Buch	N
Bilderbuchhersteller	Bilderbuch	Buch	N
Bilderbuch-Hessentag	Bilderbuch	Ideal	Y
Bilderbuchhochzeit	Bilderbuch	Ideal	Y
Bilderbuchidyll	Bilderbuch	Ideal	Y
Bilderbuchillustration	Bilderbuch	Buch	N
Bilderbuch-Immobilie	Bilderbuch	Ideal	Y
Bilderbuchinszenierung	Bilderbuch	Ideal	Y
Bilderbuchintegration	Bilderbuch	Ideal	Y
Bilderbuch-Intellektueller	Bilderbuch	Ideal	Y
Bilderbuchjahrgang	Bilderbuch	Ideal	Y
Bilderbuch-Japaner	Bilderbuch	Ideal	Y
Bilderbuch-Kabinett	Bilderbuch	Ideal	Y
Bilderbuchkarriere	Bilderbuch	Ideal	Y
Bilderbuchkegel	Bilderbuch	Ideal	Y
Bilderbuchkindheit	Bilderbuch	Ideal	Y
Bilderbuch-Kleinstadt	Bilderbuch	Ideal	Y
Bilderbuchklima	Bilderbuch	Ideal	Y
Bilderbuch-Klinik	Bilderbuch	Ideal	Y
Bilderbuch-Kollektion	Bilderbuch	Buch	N
Bilderbuch-Konter	Bilderbuch	Ideal	Y
Bilderbuchkritik	Bilderbuch	Buch	N
Bilderbuch-Kugeltragen	Bilderbuch	Ideal	Y
Bilderbuchkulisse	Bilderbuch	Ideal	Y
Bilderbuch-Kulturbonze	Bilderbuch	Ideal	Y
Bilderbuchkunst	Bilderbuch	Buch	N
Bilderbuch-Künstler	Bilderbuch	Buch	N
Bilderbuch-Kuschelecke	Bilderbuch	Ideal	Y
Bilderbuchküste	Bilderbuch	Ideal	Y
Bilderbuchlandschaft	Bilderbuch	Ideal	Y
Bilderbuchlandung	Bilderbuch	Ideal	Y
Bilderbuchlaufbahn	Bilderbuch	Ideal	Y
Bilderbuchlauf	Bilderbuch	Ideal	Y
Bilderbuchlektüre	Bilderbuch	Buch	N
Bilderbuchlesen	Bilderbuch	Buch	N
Bilderbuchleser	Bilderbuch	Buch	N
Bilderbuch-Lesung	Bilderbuch	Buch	N
Bilderbuch-Licht	Bilderbuch	Ideal	Y
Bilderbuchmacho	Bilderbuch	Ideal	Y
Bilderbuchmädchen	Bilderbuch	Ideal	Y
Bilderbuchmafiosi	Bilderbuch	Ideal	Y
Bilderbuch-Mama	Bilderbuch	Ideal	Y
Bilderbuchmanier	Bilderbuch	Ideal	Y
Bilderbuch-Märchen	Bilderbuch	Buch	N
Bilderbuchmessias	Bilderbuch	Ideal	Y
Bilderbuch-Münchener	Bilderbuch	Ideal	Y
Bilderbuchmuseum	Bilderbuch	Buch	N
Bilderbuchnaturbursche	Bilderbuch	Ideal	Y
Bilderbuch-Nazi	Bilderbuch	Ideal	Y
Bilderbuch-Not	Bilderbuch	Buch	N
Bilderbuch-Oma	Bilderbuch	Ideal	Y
Bilderbuch-Paar	Bilderbuch	Ideal	Y
Bilderbuchpaket	Bilderbuch	Buch	N
Bilderbuch-Panorama	Bilderbuch	Ideal	Y
Bilderbuchpatientin	Bilderbuch	Ideal	Y
Bilderbuchplanwagen	Bilderbuch	Ideal	Y
Bilderbuch-Platanenallee	Bilderbuch	Ideal	Y
Bilderbuchpolizistin	Bilderbuch	Ideal	Y
Bilderbuch-Prag	Bilderbuch	Ideal	Y
Bilderbuchpräsident	Bilderbuch	Ideal	Y
Bilderbuchprinzessin	Bilderbuch	Ideal	Y
Bilderbuchproduktion	Bilderbuch	Buch	N
Bilderbuchprogramm	Bilderbuch	Ideal	Y
Bilderbuchprojekt	Bilderbuch	Buch	N
Bilderbuchputsch	Bilderbuch	Ideal	Y
Bilderbuchreaktion	Bilderbuch	Ideal	Y
Bilderbuch-Referenzen	Bilderbuch	Ideal	Y
Bilderbuchreihe	Bilderbuch	Buch	N
Bilderbuchreiseführer	Bilderbuch	Buch	N
Bilderbuchreise	Bilderbuch	Ideal	Y
Bilderbuchromantik	Bilderbuch	Ideal	Y
Bilderbuchsadist	Bilderbuch	Ideal	Y
Bilderbuchsaison	Bilderbuch	Ideal	Y
Bilderbuchschauen	Bilderbuch	Buch	N
Bilderbuch-Schildbürgerstreich	Bilderbuch	Ideal	Y
Bilderbuchschloss	Bilderbuch	Ideal	Y
Bilderbuchschmökerei	Bilderbuch	Buch	N
Bilderbuchschreiber	Bilderbuch	Buch	N
Bilderbuchseite	Bilderbuch	Buch	N
Bilderbuchsommer	Bilderbuch	Ideal	Y
Bilderbuchsommernacht	Bilderbuch	Ideal	Y
Bilderbuchsonntag	Bilderbuch	Ideal	Y
Bilderbuch-Sozialarbeit	Bilderbuch	Ideal	Y
Bilderbuch-Sozi	Bilderbuch	Ideal	Y
Bilderbuchspanien	Bilderbuch	Ideal	Y
Bilderbuch-Spaß	Bilderbuch	Buch	N
Bilderbuchsprache	Bilderbuch	Buch	N
Bilderbuchstadion	Bilderbuch	Ideal	Y
Bilderbuch-Städtchen	Bilderbuch	Ideal	Y
Bilderbuch-Start	Bilderbuch	Ideal	Y
Bilderbuchsteg	Bilderbuch	Ideal	Y
Bilderbuch-Stelle	Bilderbuch	Ideal	Y
Bilderbuchstil	Bilderbuch	Buch	N
Bilderbuch-Südstaatentyp	Bilderbuch	Ideal	Y
Bilderbuchsymptom	Bilderbuch	Ideal	Y
Bilderbuchszene	Bilderbuch	Buch	N
Bilderbuch-Thema	Bilderbuch	Buch	N
Bilderbuchtitel	Bilderbuch	Buch	N
Bilderbuchtor	Bilderbuch	Ideal	Y
Bilderbuch-Türsteher	Bilderbuch	Ideal	Y
Bilderbuchumschlag	Bilderbuch	Buch	N
Bilderbuchvater	Bilderbuch	Ideal	Y
Bilderbuchvertreter	Bilderbuch	Ideal	Y
Bilderbuchvertrieb	Bilderbuch	Buch	N
Bilderbuch-Villa	Bilderbuch	Ideal	Y
Bilderbuch-Vorfrühling	Bilderbuch	Ideal	Y
Bilderbuchvulkan	Bilderbuch	Ideal	Y
Bilderbuchwald	Bilderbuch	Ideal	Y
Bilderbuch-Weihnachtsmann	Bilderbuch	Ideal	Y
Bilderbuchwettbewerb	Bilderbuch	Buch	N
Bilderbuchwetter	Bilderbuch	Ideal	Y
Bilderbuchwinter	Bilderbuch	Ideal	Y
Bilderbuchwirtshaus	Bilderbuch	Ideal	Y
Bilderbuch-Wissenschaft	Bilderbuch	Ideal	Y
Bilderbuchwitterung	Bilderbuch	Ideal	Y
Bilderbuchwoche	Bilderbuch	Ideal	Y
Bilderbuchzeichner	Bilderbuch	Buch	N
Bilderbuch-Zeuge	Bilderbuch	Ideal	Y
Blitzabsprache	Blitz	Geschwindigkeit	Y
Blitzabwender	Blitz	Physik	N
Blitzadapter	Blitz	Fotographie	N
Blitzaffäre	Blitz	Geschwindigkeit	Y
Blitzaktivität	Blitz	Physik	N
Blitzampel	Blitz	Fotographie	N
Blitzangst	Blitz	Physik	N
Blitzanschluss	Blitz	Geschwindigkeit	Y
Blitzarme	Blitz	Physik	N
Blitzarten	Blitz	Physik	N
Blitzäste	Blitz	Physik	N
Blitz-Attacke	Blitz	Geschwindigkeit	Y
Blitzaufstieg	Blitz	Geschwindigkeit	Y
Blitzauswertung	Blitz	Geschwindigkeit	Y
Blitzautomat	Blitz	Fotographie	N
Blitzballspieler	Blitz	Geschwindigkeit	Y
Blitz-Bauzeit	Blitz	Geschwindigkeit	Y
Blitzbeförderung	Blitz	Geschwindigkeit	Y
Blitzbenutzung	Blitz	Fotographie	N
Blitzbesichtigung	Blitz	Geschwindigkeit	Y
Blitz-Bewerbung	Blitz	Geschwindigkeit	Y
Blitzbewertung	Blitz	Geschwindigkeit	Y
Blitzbingo	Blitz	Geschwindigkeit	Y
Blitzblähung	Blitz	Geschwindigkeit	Y
Blitzblume	Blitz	Physik	N
Blitzbodenkarton	Blitz	UNV	N
Blitzbomber	Blitz	Geschwindigkeit	Y
Blitzbrief	Blitz	Geschwindigkeit	Y
Blitzbrille	Blitz	Physik	N
Blitzbulimie	Blitz	Geschwindigkeit	Y
Blitz-Casting	Blitz	Geschwindigkeit	Y
Blitzdemo	Blitz	Geschwindigkeit	Y
Blitz-Deportation	Blitz	Geschwindigkeit	Y
Blitzdiagnose	Blitz	Geschwindigkeit	Y
Blitzdichte	Blitz	Physik	N
Blitzdichterin	Blitz	Geschwindigkeit	Y
Blitzdraht	Blitz	Physik	N
Blitz-Ehe	Blitz	Geschwindigkeit	Y
Blitzeiche	Blitz	Physik	N
Blitzeinbruch	Blitz	Geschwindigkeit	Y
Blitzeinsatz	Blitz	Fotographie	N
Blitzeinschätzung	Blitz	Geschwindigkeit	Y
Blitzeinschlaghäufigkeit	Blitz	Physik	N
Blitzeinstieg	Blitz	Geschwindigkeit	Y
Blitzeinwirkungen	Blitz	Physik	N
Blitzeinzelmeisterschaften	Blitz	Geschwindigkeit	Y
Blitz-Eis	Blitz	Geschwindigkeit	Y
Blitzelemente	Blitz	Fotographie	N
Blitzentladung	Blitz	Physik	N
Blitzentscheid	Blitz	Geschwindigkeit	Y
Blitzentscheidung	Blitz	Geschwindigkeit	Y
Blitzerfolg	Blitz	Geschwindigkeit	Y
Blitzerlebnis	Blitz	Physik	N
Blitzeroberung	Blitz	Geschwindigkeit	Y
Blitz-Evakuierung	Blitz	Geschwindigkeit	Y
Blitzexperte	Blitz	Physik	N
Blitzfähigkeiten	Blitz	Fotographie	N
Blitz-Fahrgestell	Blitz	Fotographie	N
Blitzfänger	Blitz	Physik	N
Blitzfeldzug	Blitz	Geschwindigkeit	Y
Blitzforscher	Blitz	Physik	N
Blitz-Fotografie	Blitz	Fotographie	N
Blitzführung	Blitz	Geschwindigkeit	Y
Blitzfunk	Blitz	Geschwindigkeit	Y
Blitzgeber	Blitz	Fotographie	N
Blitzgeburt	Blitz	Geschwindigkeit	Y
Blitzgedanke	Blitz	Geschwindigkeit	Y
Blitzgefrieren	Blitz	Geschwindigkeit	Y
Blitz-Gegentore	Blitz	Geschwindigkeit	Y
Blitzgegner	Blitz	Geschwindigkeit	Y
Blitzgerät	Blitz	Fotographie	N
Blitzgericht	Blitz	Geschwindigkeit	Y
Blitzgerüst	Blitz	Fotographie	N
Blitzgeschoss	Blitz	Geschwindigkeit	Y
Blitzgesetzesänderung	Blitz	Geschwindigkeit	Y
Blitzgewitter	Blitz	Physik	N
Blitz-Gipfel	Blitz	Geschwindigkeit	Y
Blitzglut	Blitz	Physik	N
Blitzgruß	Blitz	Geschwindigkeit	Y
Blitzguss	Blitz	Geschwindigkeit	Y
Blitzhauptverhandlung	Blitz	Geschwindigkeit	Y
Blitz-Hefe	Blitz	Geschwindigkeit	Y
Blitzheilung	Blitz	Geschwindigkeit	Y
Blitzheirat	Blitz	Geschwindigkeit	Y
Blitzhypnose	Blitz	Geschwindigkeit	Y
Blitz-Hypnotiseur	Blitz	Geschwindigkeit	Y
Blitzidee	Blitz	Geschwindigkeit	Y
Blitzinfo	Blitz	Geschwindigkeit	Y
Blitzinterview	Blitz	Geschwindigkeit	Y
Blitzinvasion	Blitz	Geschwindigkeit	Y
Blitzjäger	Blitz	Physik	N
Blitz-Journal	Blitz	Physik	N
Blitzkameras	Blitz	Fotographie	N
Blitzkampf	Blitz	Geschwindigkeit	Y
Blitzkarriere	Blitz	Geschwindigkeit	Y
Blitz-Käsekuchen	Blitz	Geschwindigkeit	Y
Blitzkassiererin	Blitz	Geschwindigkeit	Y
Blitzkatastrophen	Blitz	Physik	N
Blitzkegel	Blitz	Physik	N
Blitzknabe	Blitz	Physik	N
Blitzknallböller	Blitz	Physik	N
Blitz-Knall	Blitz	Physik	N
Blitzkompensator	Blitz	Physik	N
Blitzkrach	Blitz	Geschwindigkeit	Y
Blitzkrieg	Blitz	Geschwindigkeit	Y
Blitz-Kur	Blitz	Geschwindigkeit	Y
Blitzkurs	Blitz	Geschwindigkeit	Y
Blitzlampe	Blitz	Fotographie	N
Blitzlehre	Blitz	Physik	N
Blitzleim	Blitz	Geschwindigkeit	Y
Blitz-Lektion	Blitz	Geschwindigkeit	Y
Blitz-Lernen	Blitz	Geschwindigkeit	Y
Blitzlesen	Blitz	Geschwindigkeit	Y
Blitz-Licht	Blitz	Fotographie	N
Blitzliteratur	Blitz	Geschwindigkeit	Y
Blitzlösung	Blitz	Geschwindigkeit	Y
Blitzmästung	Blitz	Geschwindigkeit	Y
Blitzmessadapter	Blitz	Physik	N
Blitzmontagen	Blitz	Geschwindigkeit	Y
Blitzmörtel	Blitz	Geschwindigkeit	Y
Blitzmuffel	Blitz	Geschwindigkeit	Y
Blitznähe	Blitz	Physik	N
Blitznarbe	Blitz	Physik	N
Blitzneiger	Blitz	Fotographie	N
Blitz-News	Blitz	Geschwindigkeit	Y
Blitzniederlage	Blitz	Geschwindigkeit	Y
Blitzoperation	Blitz	Geschwindigkeit	Y
Blitzopfern	Blitz	Physik	N
Blitz-Orgasmus	Blitz	Geschwindigkeit	Y
Blitzortung	Blitz	Physik	N
Blitzparty	Blitz	Geschwindigkeit	Y
Blitzpfeil	Blitz	Physik	N
Blitzprofi	Blitz	Physik	N
Blitz-Protestaktion	Blitz	Geschwindigkeit	Y
Blitzrasur	Blitz	Geschwindigkeit	Y
Blitz-Raub	Blitz	Geschwindigkeit	Y
Blitz-Recherche	Blitz	Geschwindigkeit	Y
Blitzrechnens	Blitz	Geschwindigkeit	Y
Blitzrechnung	Blitz	Geschwindigkeit	Y
Blitzreflexe	Blitz	Geschwindigkeit	Y
Blitz-Reflexionen	Blitz	Fotographie	N
Blitzreinigung	Blitz	Geschwindigkeit	Y
Blitzreise	Blitz	Geschwindigkeit	Y
Blitz-Remake	Blitz	Geschwindigkeit	Y
Blitzresistenz	Blitz	Physik	N
Blitzrezept	Blitz	Geschwindigkeit	Y
Blitzröhre	Blitz	Physik	N
Blitz-Rücktritt	Blitz	Geschwindigkeit	Y
Blitzsalve	Blitz	Fotographie	N
Blitzsätzen	Blitz	Physik	N
Blitzsauberkeit	Blitz	Fehlt	N
Blitzschach	Blitz	Geschwindigkeit	Y
Blitzscheidung	Blitz	Geschwindigkeit	Y
Blitzschicht	Blitz	Fotographie	N
Blitzschlag	Blitz	Physik	N
Blitzschwert	Blitz	Physik	N
Blitzsekunde	Blitz	Geschwindigkeit	Y
Blitzsensor	Blitz	Fotographie	N
Blitzservice	Blitz	Geschwindigkeit	Y
Blitzsicherheit	Blitz	Physik	N
Blitzsieg	Blitz	Geschwindigkeit	Y
Blitzsimulator	Blitz	Physik	N
Blitzsimultankampf	Blitz	Geschwindigkeit	Y
Blitzsöldner	Blitz	Physik	N
Blitzspezialist	Blitz	Geschwindigkeit	Y
Blitzspieler	Blitz	Geschwindigkeit	Y
Blitzstärke	Blitz	Physik	N
Blitz-Steuerung	Blitz	Fotographie	N
Blitzstich	Blitz	Geschwindigkeit	Y
Blitzstrom	Blitz	Physik	N
Blitzsystem	Blitz	Fotographie	N
Blitztage	Blitz	Geschwindigkeit	Y
Blitztätowierung	Blitz	Geschwindigkeit	Y
Blitztechnik	Blitz	Fotographie	N
Blitztelegram	Blitz	Geschwindigkeit	Y
Blitztest	Blitz	Geschwindigkeit	Y
Blitz-Tiebreak	Blitz	Geschwindigkeit	Y
Blitztipp	Blitz	Geschwindigkeit	Y
Blitz-Titelkampf	Blitz	Geschwindigkeit	Y
Blitztor	Blitz	Geschwindigkeit	Y
Blitz-Totem	Blitz	UNV	N
Blitzträger	Blitz	Physik	N
Blitztreffen	Blitz	Geschwindigkeit	Y
Blitzübersichtskarte	Blitz	Physik	N
Blitz-Umfrage	Blitz	Geschwindigkeit	Y
Blitzurlaub	Blitz	Geschwindigkeit	Y
Blitzurteil	Blitz	Geschwindigkeit	Y
Blitzverführung	Blitz	Geschwindigkeit	Y
Blitzversuch	Blitz	Geschwindigkeit	Y
Blitzvisite	Blitz	Geschwindigkeit	Y
Blitz-Vormachtsstellung	Blitz	Geschwindigkeit	Y
Blitz-Vortrag	Blitz	Geschwindigkeit	Y
Blitzwahl	Blitz	Geschwindigkeit	Y
Blitz-Wahlkampftour	Blitz	Geschwindigkeit	Y
Blitzwand	Blitz	Physik	N
Blitzwechsel	Blitz	Geschwindigkeit	Y
Blitzwelle	Blitz	Physik	N
Blitz-Widerstand	Blitz	Physik	N
Blitz-Wochenende	Blitz	Geschwindigkeit	Y
Blitzzauber	Blitz	Physik	N
Blitzzügen	Blitz	Geschwindigkeit	Y
Bombenabwurfgebiet	Bombe	Sprengkörper	N
Bomben-Abwurf-Platz	Bombe	Sprengkörper	N
Bombenabwurf	Bombe	Sprengkörper	N
Bombenabwurftestgelände	Bombe	Sprengkörper	N
Bombenabwurfzone	Bombe	Sprengkörper	N
Bombenalarm	Bombe	Sprengkörper	N
Bombenanschlagabwehr-Trupp	Bombe	Sprengkörper	N
Bomben-Arbeitsplatz	Bombe	Hervorragendes	Y
Bombenarsenal	Bombe	Sprengkörper	N
Bombenattacke	Bombe	Sprengkörper	N
Bomben-Attentäter	Bombe	Sprengkörper	N
BOMBEN-ATTENTAT		Sprengkörper	N
Bombenattrappe	Bombe	Sprengkörper	N
Bombenauftakt	Bombe	Hervorragendes	Y
Bombenbastelei	Bombe	Sprengkörper	N
Bombenbauer	Bombe	Sprengkörper	N
Bombenbeginn	Bombe	Hervorragendes	Y
Bombenbehälter	Bombe	Sprengkörper	N
Bombenbeitrag	Bombe	Hervorragendes	Y
Bombenbekämpfung	Bombe	Sprengkörper	N
Bomben-Beschluß	Bombe	Sprengkörper	N
Bomben-Blindgänger	Bombe	Sprengkörper	N
Bombenchance	Bombe	Hervorragendes	Y
Bombendesign	Bombe	Hervorragendes	Y
Bombendetektor	Bombe	Sprengkörper	N
Bombendetonation	Bombe	Sprengkörper	N
Bombendiktat	Bombe	Sprengkörper	N
Bombending	Bombe	Hervorragendes	Y
Bombendrama	Bombe	Hervorragendes	Y
Bombendröhnen	Bombe	Sprengkörper	N
Bombendrohung	Bombe	Sprengkörper	N
Bombeneinsatzkommando	Bombe	Sprengkörper	N
Bombeneinstand	Bombe	Hervorragendes	Y
Bombeneinwirkung	Bombe	Sprengkörper	N
Bombenentschärfung	Bombe	Sprengkörper	N
Bomben-Entscheidung	Bombe	Hervorragendes	Y
Bombenergebnis	Bombe	Hervorragendes	Y
Bombenevakuierte	Bombe	Sprengkörper	N
Bomben-Experte	Bombe	Sprengkörper	N
Bombenexplosion	Bombe	Sprengkörper	N
Bombenfächer	Bombe	Sprengkörper	N
Bomben-Falle	Bombe	Sprengkörper	N
Bombenfallout	Bombe	Sprengkörper	N
Bombenfamilie	Bombe	Hervorragendes	Y
Bombenfehlalarme	Bombe	Sprengkörper	N
Bombenfehlwurf	Bombe	Sprengkörper	N
Bombenfeuerwerk	Bombe	Sprengkörper	N
Bombenfimmel	Bombe	Sprengkörper	N
Bombenfliegern	Bombe	Sprengkörper	N
Bombenflüchtlingsfahrt	Bombe	Sprengkörper	N
Bombenfolter	Bombe	Sprengkörper	N
Bombenform	Bombe	Hervorragendes	Y
Bombenfreistoß	Bombe	Hervorragendes	Y
Bombenfund	Bombe	Sprengkörper	N
Bombengaudi	Bombe	Hervorragendes	Y
Bombengedröhn	Bombe	Sprengkörper	N
Bombengeknalle	Bombe	Sprengkörper	N
Bombengeschwader	Bombe	Sprengkörper	N
Bombengestell	Bombe	Sprengkörper	N
Bombengewicht	Bombe	Sprengkörper	N
Bombengewitter	Bombe	Sprengkörper	N
Bombengott	Bombe	Sprengkörper	N
Bombengräuel	Bombe	Sprengkörper	N
Bombengründen	Bombe	Hervorragendes	Y
Bombengürtel	Bombe	Sprengkörper	N
Bombenhagel	Bombe	Sprengkörper	N
Bombenhersteller	Bombe	Sprengkörper	N
Bombenhirn	Bombe	Hervorragendes	Y
Bombenhund	Bombe	Sprengkörper	N
Bomben-Hysterie	Bombe	Sprengkörper	N
Bombenidee	Bombe	Hervorragendes	Y
Bombeninferno	Bombe	Sprengkörper	N
Bombeningenieur	Bombe	Sprengkörper	N
Bombenjahr	Bombe	Hervorragendes	Y
Bomben-Job	Bombe	Hervorragendes	Y
Bombenjunge	Bombe	Hervorragendes	Y
Bomben-Kader	Bombe	Hervorragendes	Y
Bombenkalorimetrie	Bombe	Fehlt	N
Bombenkampagne	Bombe	Sprengkörper	N
Bombenkandelaber	Bombe	Sprengkörper	N
Bombenkanone	Bombe	Sprengkörper	N
Bombenkanzler	Bombe	Hervorragendes	Y
Bombenkarriere	Bombe	Hervorragendes	Y
Bombenkern	Bombe	Sprengkörper	N
Bombenkessel	Bombe	Sprengkörper	N
Bombenkette	Bombe	Sprengkörper	N
Bombenkinder	Bombe	Sprengkörper	N
Bombenkippe	Bombe	Sprengkörper	N
Bombenkoffer	Bombe	Sprengkörper	N
Bomben-Kombination	Bombe	Hervorragendes	Y
Bombenkomponenten	Bombe	Sprengkörper	N
Bomben-Kondition	Bombe	Hervorragendes	Y
Bombenkongress	Bombe	Hervorragendes	Y
Bombenkörper	Bombe	Sprengkörper	N
Bombenkrater	Bombe	Sprengkörper	N
Bomben-Krieg	Bombe	Sprengkörper	N
Bombenkugel	Bombe	Sprengkörper	N
Bombenkurs	Bombe	Hervorragendes	Y
Bombenladeraum	Bombe	Sprengkörper	N
Bombenlauf	Bombe	Hervorragendes	Y
Bombenlaune	Bombe	Hervorragendes	Y
Bombenleger	Bombe	Sprengkörper	N
Bomben-Leistung	Bombe	Hervorragendes	Y
Bombenlied	Bombe	Hervorragendes	Y
Bomben-Luke	Bombe	Sprengkörper	N
Bomben-Marktanteil	Bombe	Hervorragendes	Y
Bomben-Massenmassaker	Bombe	Sprengkörper	N
Bomben-Mission	Bombe	Sprengkörper	N
Bombenmodus	Bombe	Sprengkörper	N
Bombenmörser	Bombe	Sprengkörper	N
Bombennacht	Bombe	Hervorragendes	Y
Bombenneigung	Bombe	Sprengkörper	N
Bombenneurose	Bombe	Sprengkörper	N
Bombenopfergräberfeld	Bombe	Sprengkörper	N
Bombenopfer	Bombe	Sprengkörper	N
Bombenpeter	Bombe	Sprengkörper	N
Bombenplatte	Bombe	Hervorragendes	Y
Bombenplatz	Bombe	Sprengkörper	N
Bombenpolitik	Bombe	Hervorragendes	Y
Bombenpotential	Bombe	Hervorragendes	Y
Bombenpraxis	Bombe	Hervorragendes	Y
Bombenpreis	Bombe	Hervorragendes	Y
Bomben-Produktionsstätte	Bombe	Sprengkörper	N
Bombenprozeß	Bombe	Sprengkörper	N
Bombenquote	Bombe	Hervorragendes	Y
Bomben-Rakete	Bombe	Sprengkörper	N
Bombenräumung	Bombe	Sprengkörper	N
Bombenreklame	Bombe	Hervorragendes	Y
Bombenreportage	Bombe	Hervorragendes	Y
Bombenrest	Bombe	Sprengkörper	N
Bombenrichtgerät	Bombe	Sprengkörper	N
Bombenring	Bombe	Sprengkörper	N
Bombenritt	Bombe	Hervorragendes	Y
Bombenrohr	Bombe	Sprengkörper	N
Bombenrücklaufergebnis	Bombe	Hervorragendes	Y
Bombenruine	Bombe	Sprengkörper	N
Bombensalve	Bombe	Sprengkörper	N
Bombenschacht	Bombe	Sprengkörper	N
Bombenschaden	Bombe	Sprengkörper	N
Bombenschlacht	Bombe	Sprengkörper	N
Bombenschmeißen	Bombe	Sprengkörper	N
Bomben-Schmuggel	Bombe	Sprengkörper	N
Bombenschnitt	Bombe	Hervorragendes	Y
Bombenschock	Bombe	Sprengkörper	N
Bombenschutt	Bombe	Sprengkörper	N
Bombenschutzkeller	Bombe	Sprengkörper	N
Bombenserie	Bombe	Hervorragendes	Y
Bombensicherheit	Bombe	Sprengkörper	N
Bombensituation	Bombe	Hervorragendes	Y
Bombensoftware	Bombe	Hervorragendes	Y
Bomben-Spaß	Bombe	Hervorragendes	Y
Bombenspektakel	Bombe	Hervorragendes	Y
Bombenspezialist	Bombe	Sprengkörper	N
Bombenspielplatz	Bombe	Sprengkörper	N
Bombensplitter	Bombe	Sprengkörper	N
Bombensprengung	Bombe	Sprengkörper	N
Bombenspuren	Bombe	Sprengkörper	N
Bombenspurt	Bombe	Hervorragendes	Y
Bombenstart	Bombe	Hervorragendes	Y
Bombenstoff	Bombe	Sprengkörper	N
Bombenstürmen	Bombe	Sprengkörper	N
Bombensucharbeiten	Bombe	Sprengkörper	N
Bombentänzer	Bombe	Hervorragendes	Y
Bombentasche	Bombe	Sprengkörper	N
Bombenteam	Bombe	Hervorragendes	Y
Bombentechnik	Bombe	Hervorragendes	Y
Bombentechnologie	Bombe	Sprengkörper	N
Bombenteil	Bombe	Sprengkörper	N
Bombenteppich	Bombe	Sprengkörper	N
Bombenterror	Bombe	Sprengkörper	N
Bombentest	Bombe	Sprengkörper	N
Bombenthema	Bombe	Hervorragendes	Y
Bombenthese	Bombe	Hervorragendes	Y
Bombentoter	Bombe	Sprengkörper	N
Bombentrack	Bombe	Hervorragendes	Y
Bombentrichter	Bombe	Sprengkörper	N
Bombentruppe	Bombe	Hervorragendes	Y
Bombenüberraschung	Bombe	Hervorragendes	Y
Bomben-Unfall	Bombe	Sprengkörper	N
Bombenunglück	Bombe	Sprengkörper	N
Bombenverbindung	Bombe	Hervorragendes	Y
Bombenverdacht	Bombe	Sprengkörper	N
Bombenverschwörung	Bombe	Sprengkörper	N
Bomben-Verstärker	Bombe	Hervorragendes	Y
Bombenversteck	Bombe	Hervorragendes	Y
Bomben-Verwundungen	Bombe	Sprengkörper	N
Bomben-Verzögerung	Bombe	Sprengkörper	N
Bombenvolltreffer	Bombe	Hervorragendes	Y
Bombenvorhaben	Bombe	Hervorragendes	Y
Bombenwahlerfolg	Bombe	Hervorragendes	Y
Bombenwarnung	Bombe	Sprengkörper	N
Bombenwein	Bombe	Hervorragendes	Y
Bombenwerfer	Bombe	Sprengkörper	N
Bombenweste	Bombe	Sprengkörper	N
Bombenwetter	Bombe	Hervorragendes	Y
Bombenwitz	Bombe	Hervorragendes	Y
Bombenwoche	Bombe	Hervorragendes	Y
Bomben-Wochen	Bombe	Hervorragendes	Y
Bombenwurfangriff	Bombe	Sprengkörper	N
Bomben-Zündkabel	Bombe	Sprengkörper	N
Bomben-Zündung	Bombe	Sprengkörper	N
Glanzabend	Glanz	Auffälligkeit	Y
Glanzabitur	Glanz	Auffälligkeit	Y
Glanzakrobat	Glanz	Auffälligkeit	Y
Glanzaktion	Glanz	Auffälligkeit	Y
Glanzakzent	Glanz	Auffälligkeit	Y
Glanzanteil	Glanz	Leuchten	N
Glanzarbeit	Glanz	Auffälligkeit	Y
Glanzargument	Glanz	Auffälligkeit	Y
Glanzaufnahme	Glanz	Auffälligkeit	Y
Glanzauftritt	Glanz	Auffälligkeit	Y
Glanzauge	Glanz	Leuchten	N
Glanzausrüstungsmittel	Glanz	Leuchten	N
Glanzbeere	Glanz	Leuchten	N
Glanzbeispiel	Glanz	Auffälligkeit	Y
Glanzbelag	Glanz	Leuchten	N
Glanzbereich	Glanz	Auffälligkeit	Y
Glanzbeschichtung	Glanz	Leuchten	N
Glanzbesetzung	Glanz	Auffälligkeit	Y
Glanzbezug	Glanz	Leuchten	N
Glanzbildchen	Glanz	Leuchten	N
Glanzbild	Glanz	Leuchten	N
Glanzblech	Glanz	Leuchten	N
Glanzbrand	Glanz	Leuchten	N
Glanzbroschüre	Glanz	Leuchten	N
Glanzcomeback	Glanz	Auffälligkeit	Y
Glanzcover	Glanz	Leuchten	N
Glanzcreme	Glanz	Leuchten	N
Glanzdarstellung	Glanz	Auffälligkeit	Y
Glanzdekade	Glanz	Auffälligkeit	Y
Glanz-Disziplin	Glanz	Auffälligkeit	Y
Glanz-Effekt	Glanz	Leuchten	N
Glanzeigenschaften	Glanz	Leuchten	N
Glanzeinsatz	Glanz	Leuchten	N
Glanz-Email-Masse	Glanz	Leuchten	N
Glanzemulsion	Glanz	Leuchten	N
Glanzente	Glanz	Leuchten	N
Glanzentfaltung	Glanz	Leuchten	N
Glanzepisode	Glanz	Auffälligkeit	Y
Glanzepoche	Glanz	Auffälligkeit	Y
Glanzesfunke	Glanz	adjudicated	N
Glanzextemporale	Glanz	Auffälligkeit	Y
Glanzfach	Glanz	Auffälligkeit	Y
Glanzfahrt	Glanz	Auffälligkeit	Y
Glanzfarbe	Glanz	Leuchten	N
Glanzfasan	Glanz	Leuchten	N
Glanzfassade	Glanz	Leuchten	N
Glanzfehler	Glanz	Leuchten	N
Glanzfeinheit	Glanz	Leuchten	N
Glanzfeld	Glanz	Leuchten	N
Glanzfigur	Glanz	Auffälligkeit	Y
Glanzfleck	Glanz	Leuchten	N
Glanzflut	Glanz	Leuchten	N
Glanzfolge	Glanz	Auffälligkeit	Y
Glanzfolie	Glanz	Leuchten	N
Glanzformat	Glanz	Auffälligkeit	Y
Glanzform	Glanz	Auffälligkeit	Y
Glanzfuge	Glanz	Leuchten	N
Glanz-Gag	Glanz	Auffälligkeit	Y
Glanzgänse	Glanz	Leuchten	N
Glanzgarn	Glanz	Leuchten	N
Glanzgefieder	Glanz	Leuchten	N
Glanzgefilde	Glanz	Auffälligkeit	Y
Glanzgesicht	Glanz	Leuchten	N
Glanzgestein	Glanz	Leuchten	N
Glanzgold	Glanz	Leuchten	N
Glanzgrad	Glanz	Leuchten	N
Glanzhaare	Glanz	Leuchten	N
Glanzhaut	Glanz	Leuchten	N
Glanzheftchen	Glanz	Leuchten	N
Glanzheide	Glanz	Leuchten	N
Glanzhelm	Glanz	Leuchten	N
Glanzhose	Glanz	Leuchten	N
Glanzhure	Glanz	Auffälligkeit	Y
Glanzidee	Glanz	Auffälligkeit	Y
Glanzjahr	Glanz	Auffälligkeit	Y
Glanzkäfer	Glanz	Leuchten	N
Glanz-Kapitel	Glanz	Auffälligkeit	Y
Glanzkarriere	Glanz	Auffälligkeit	Y
Glanzkartonbogen	Glanz	Leuchten	N
Glanzkarton	Glanz	Leuchten	N
Glanzkattun	Glanz	Leuchten	N
Glanzkino	Glanz	Auffälligkeit	Y
Glanz-Klasse	Glanz	Auffälligkeit	Y
Glanzkölbchen	Glanz	Leuchten	N
Glanz-Komödie	Glanz	Auffälligkeit	Y
Glanzkraut	Glanz	Leuchten	N
Glanzkreiß	Glanz	Leuchten	N
Glanzkupfer	Glanz	Leuchten	N
Glanzkür	Glanz	Auffälligkeit	Y
Glanzkuren	Glanz	Leuchten	N
Glanzlauf	Glanz	Auffälligkeit	Y
Glanzleder	Glanz	Leuchten	N
Glanzleggings	Glanz	Leuchten	N
Glanzleinen	Glanz	Leuchten	N
Glanzleinwand	Glanz	Leuchten	N
Glanzleistung	Glanz	Auffälligkeit	Y
Glanzlicht	Glanz	Auffälligkeit	Y
Glanzlidschatten	Glanz	Leuchten	N
Glanzliebe	Glanz	Auffälligkeit	Y
Glanzlook	Glanz	Leuchten	N
Glanzmagazinen	Glanz	Auffälligkeit	Y
Glanzmähne	Glanz	Leuchten	N
Glanzmarkierungen	Glanz	Leuchten	N
Glanzmeer	Glanz	Leuchten	N
Glanzminute	Glanz	Auffälligkeit	Y
Glanzmittel	Glanz	Leuchten	N
Glanzmoment	Glanz	Auffälligkeit	Y
Glanznägel	Glanz	Leuchten	N
Glanzniveau	Glanz	Auffälligkeit	Y
Glanznoten	Glanz	Auffälligkeit	Y
Glanznummer	Glanz	Auffälligkeit	Y
Glanz-Optik	Glanz	Leuchten	N
Glanzorchester	Glanz	Auffälligkeit	Y
Glanzpaket	Glanz	Leuchten	N
Glanzpapier	Glanz	Leuchten	N
Glanzpapierprospekt	Glanz	Leuchten	N
Glanzparade	Glanz	Auffälligkeit	Y
Glanzpartie	Glanz	Auffälligkeit	Y
Glanzpartikel	Glanz	Leuchten	N
Glanzpassage	Glanz	Auffälligkeit	Y
Glanzpass	Glanz	Auffälligkeit	Y
Glanzperiode	Glanz	Auffälligkeit	Y
Glanzphase	Glanz	Auffälligkeit	Y
Glanzpigmente	Glanz	Leuchten	N
Glanzpolitur	Glanz	Leuchten	N
Glanzpostkarte	Glanz	Leuchten	N
Glanzpremiere	Glanz	Auffälligkeit	Y
Glanzprospekt	Glanz	Leuchten	N
Glanzpunkt	Glanz	Auffälligkeit	Y
Glanzreaktion	Glanz	Auffälligkeit	Y
Glanzreflexion	Glanz	Leuchten	N
Glanzresultat	Glanz	Auffälligkeit	Y
Glanzritt	Glanz	Auffälligkeit	Y
Glanzrolle	Glanz	Auffälligkeit	Y
Glanzrose	Glanz	Leuchten	N
Glanzrouge	Glanz	Leuchten	N
Glanzrunde	Glanz	Auffälligkeit	Y
Glanzrüschen	Glanz	Leuchten	N
Glanzruß	Glanz	Leuchten	N
Glanzsaat	Glanz	Leuchten	N
Glanzsaison	Glanz	Auffälligkeit	Y
Glanzsamen	Glanz	Leuchten	N
Glanzschicht	Glanz	Leuchten	N
Glanzschülerin	Glanz	Auffälligkeit	Y
Glanzschuppen	Glanz	Leuchten	N
Glanzseide	Glanz	Leuchten	N
Glanzseife	Glanz	Leuchten	N
Glanzseite	Glanz	Auffälligkeit	Y
Glanzsendung	Glanz	Auffälligkeit	Y
Glanzshampoo	Glanz	Leuchten	N
Glanzshorts	Glanz	Leuchten	N
Glanzsieg	Glanz	Auffälligkeit	Y
Glanzsiegel	Glanz	Leuchten	N
Glanzsignal	Glanz	Leuchten	N
Glanzsilber	Glanz	Leuchten	N
Glanzsittiche	Glanz	Leuchten	N
Glanzspray	Glanz	Leuchten	N
Glanzspüler	Glanz	Leuchten	N
Glanzspülung	Glanz	Leuchten	N
Glanzstar	Glanz	Auffälligkeit	Y
Glanzstart	Glanz	Auffälligkeit	Y
Glanzstein	Glanz	Leuchten	N
Glanzstellen	Glanz	Leuchten	N
Glanz-Sterbe-Arie	Glanz	Auffälligkeit	Y
Glanzstern	Glanz	Leuchten	N
Glanzstiefel	Glanz	Leuchten	N
Glanzstoff	Glanz	Leuchten	N
Glanzstrauch	Glanz	Leuchten	N
Glanzstreifen	Glanz	Leuchten	N
Glanzstrumpfhose	Glanz	Leuchten	N
Glanzstück	Glanz	Auffälligkeit	Y
Glanzstückchen	Glanz	Auffälligkeit	Y
Glanzstunde	Glanz	Auffälligkeit	Y
Glanzsucht	Glanz	Auffälligkeit	Y
Glanztat	Glanz	Auffälligkeit	Y
Glanztisch	Glanz	Leuchten	N
Glanztongefäß	Glanz	Leuchten	N
Glanztonüberzug	Glanz	Leuchten	N
Glanztor	Glanz	Auffälligkeit	Y
Glanztrocknung	Glanz	Leuchten	N
Glanztupfer	Glanz	Leuchten	N
Glanzturnier	Glanz	Auffälligkeit	Y
Glanzumschlag	Glanz	Leuchten	N
Glanzuniversität	Glanz	Auffälligkeit	Y
Glanzunterschiede	Glanz	Leuchten	N
Glanzvergoldung	Glanz	Leuchten	N
Glanzviertel	Glanz	Auffälligkeit	Y
Glanzvision	Glanz	Auffälligkeit	Y
Glanzvorstellung	Glanz	Auffälligkeit	Y
Glanzvortrag	Glanz	Auffälligkeit	Y
Glanzwahl	Glanz	Auffälligkeit	Y
Glanzwelt	Glanz	Auffälligkeit	Y
Glanzwerke	Glanz	Auffälligkeit	Y
Glanzwinkel	Glanz	Leuchten	N
Glanzwirkung	Glanz	Leuchten	N
Glanzwoche	Glanz	Auffälligkeit	Y
Glanz-Wolfsmilch	Glanz	Leuchten	N
Glanzwort	Glanz	Auffälligkeit	Y
Glanzzeit	Glanz	Auffälligkeit	Y
Glanzziegel	Glanz	Leuchten	N
Glanzzwiebel	Glanz	Leuchten	N
Heidenachtung	Heide	Intensität	Y
Heidenadler	Heide	Glaube	N
Heidenaltar	Heide	Glaube	N
Heidenangst	Heide	Intensität	Y
Heidenanhänger	Heide	Glaube	N
Heidenanstrengung	Heide	Intensität	Y
Heidenapostel	Heide	Glaube	N
Heidenarbeit	Heide	Intensität	Y
Heidenärger	Heide	Intensität	Y
Heidenarmee	Heide	Glaube	N
Heidenaufriss	Heide	Intensität	Y
Heidenaufstand	Heide	Intensität	Y
Heidenaufwand	Heide	Intensität	Y
Heidenbammel	Heide	Intensität	Y
Heidenbau	Heide	Glaube	N
Heidenbaum	Heide	Glaube	N
Heidenbekehrung	Heide	Glaube	N
Heidenbelagerung	Heide	Glaube	N
Heidenbeschreibung	Heide	Glaube	N
Heidenbewegung	Heide	Glaube	N
Heidenbezwinger	Heide	Glaube	N
Heidenblamage	Heide	Intensität	Y
Heidenblütenzeit	Heide	Fehlt	N
Heidenblut	Heide	Glaube	N
Heidenbrauch	Heide	Glaube	N
Heidenbrut	Heide	Glaube	N
Heidenburg	Heide	Glaube	N
Heidenchor	Heide	Glaube	N
Heidenchristen	Heide	Glaube	N
Heidenchristenheit	Heide	Glaube	N
Heidenchristentum	Heide	Glaube	N
Heidendorf	Heide	Glaube	N
Heidendusel	Heide	Intensität	Y
Heidenepos	Heide	Glaube	N
Heidenescher	Heide	Glaube	N
Heidenfahne	Heide	Glaube	N
Heidenfahrt	Heide	Glaube	N
Heidenfeld	Heide	Glaube	N
Heidenfeste	Heide	Glaube	N
Heidenfest	Heide	Glaube	N
Heidenfeuer	Heide	Glaube	N
Heidenforum	Heide	Glaube	N
Heidenfrauen	Heide	Glaube	N
Heidenfrau	Heide	Glaube	N
Heidenfreude	Heide	Intensität	Y
Heidenfurcht	Heide	Intensität	Y
Heidenfürst	Heide	Glaube	N
Heidengarten	Heide	Glaube	N
Heidengaudi	Heide	Intensität	Y
Heidengeister	Heide	Glaube	N
Heidengeist	Heide	Glaube	N
Heidengejohle	Heide	Intensität	Y
Heidengeld	Heide	Intensität	Y
Heidengemeinde	Heide	Glaube	N
Heidengemeinschaft	Heide	Glaube	N
Heidengenosse	Heide	Glaube	N
Heidengermanen	Heide	Glaube	N
Heidengeschäft	Heide	Intensität	Y
Heidengeschichten	Heide	Glaube	N
Heidengesellschaft	Heide	Glaube	N
Heidengesocks	Heide	Glaube	N
Heidengestalten	Heide	Glaube	N
Heidengewinn	Heide	Intensität	Y
Heiden	Heide	Glaube	N
Heidenglaube	Heide	Glaube	N
Heidenglück	Heide	Intensität	Y
Heidengötter	Heide	Glaube	N
Heidengott	Heide	Glaube	N
Heidengraben	Heide	Glaube	N
Heidengräber	Heide	Glaube	N
Heidengrab	Heide	Glaube	N
Heidengut	Heide	Glaube	N
Heidenhain	Heide	Glaube	N
Heidenhäuser	Heide	Glaube	N
Heidenhaus	Heide	Glaube	N
Heidenhonorar	Heide	Intensität	Y
Heidenhorde	Heide	Glaube	N
Heidenjunge	Heide	Glaube	N
Heidenjux	Heide	Intensität	Y
Heidenkampf	Heide	Intensität	Y
Heidenkäse	Heide	Geschwindigkeit	N
Heidenkate	Heide	Glaube	N
Heidenkäte	Heide	Glaube	N
Heidenkäthe	Heide	Geschwindigkeit	N
Heidenkinder	Heide	Glaube	N
Heidenkind	Heide	Glaube	N
Heidenkindlein	Heide	Glaube	N
Heidenkirche	Heide	Glaube	N
Heidenkirchhof	Heide	Glaube	N
Heidenkohle	Heide	Intensität	Y
Heidenkönig	Heide	Glaube	N
Heidenkopf	Heide	Glaube	N
Heidenkrach	Heide	Intensität	Y
Heidenkral	Heide	Glaube	N
Heidenkrieg	Heide	Glaube	N
Heidenkult	Heide	Glaube	N
Heidenlande	Heide	Glaube	N
Heidenland	Heide	Glaube	N
Heiden-Lärm	Heide	Intensität	Y
Heidenlehre	Heide	Glaube	N
Heidenlied	Heide	Glaube	N
Heidenmailingliste	Heide	Glaube	N
Heidenmal	Heide	Glaube	N
Heidenmami	Heide	Glaube	N
Heidenmarterl	Heide	Glaube	N
Heidenmassakrieren	Heide	Glaube	N
Heidenmasse	Heide	Glaube	N
Heidenmauer	Heide	Glaube	N
Heidenmissionar	Heide	Glaube	N
Heidenmissionierung	Heide	Glaube	N
Heidenmissionsarbeit	Heide	Glaube	N
Heidenmissionsgottesdienst	Heide	Glaube	N
Heidenmisssion	Heide	Glaube	N
Heidenmord	Heide	Glaube	N
Heidenmühe	Heide	Intensität	Y
Heidenmütter	Heide	Intensität	Y
Heiden-Mystik-Forum	Heide	Glaube	N
Heidennacht	Heide	Glaube	N
Heidenoldendorf	Heide	Glaube	N
Heidenopfer	Heide	Glaube	N
Heidenpack	Heide	Glaube	N
Heidenpastor	Heide	Glaube	N
Heidenpech	Heide	Intensität	Y
Heiden-Peter	Heide	Glaube	N
Heidenpredigt	Heide	Glaube	N
Heidenpriester	Heide	Glaube	N
Heidenprozession	Heide	Glaube	N
Heidenqual	Heide	Intensität	Y
Heidenquatsch	Heide	Intensität	Y
Heidenquelle	Heide	Glaube	N
Heidenrabbi	Heide	Glaube	N
Heidenradau	Heide	Intensität	Y
Heidenreligion	Heide	Glaube	N
Heidenreligon	Heide	Glaube	N
Heidenrespekt	Heide	Intensität	Y
Heidenriegel	Heide	Glaube	N
Heidenrunde	Heide	Glaube	N
Heidenschanze	Heide	Glaube	N
Heidenscharen	Heide	Glaube	N
Heidenschar	Heide	Glaube	N
Heidenscheich	Heide	Glaube	N
Heidenschiss	Heide	Intensität	Y
Heidenschlächterei	Heide	Glaube	N
Heidenschloss	Heide	Glaube	N
Heidenschotter	Heide	Intensität	Y
Heidenschrecken	Heide	Intensität	Y
Heidenschule	Heide	Glaube	N
Heidenschuß	Heide	Glaube	N
Heidenseele	Heide	Glaube	N
Heidensender	Heide	Intensität	Y
Heidensieg	Heide	Glaube	N
Heidensinn	Heide	Glaube	N
Heidensklave	Heide	Glaube	N
Heidensohn	Heide	Glaube	N
Heidenspass	Heide	Intensität	Y
Heidenspaß	Heide	Intensität	Y
Heidenspinner	Heide	Glaube	N
Heidenspuk	Heide	Glaube	N
Heidenstamm	Heide	Glaube	N
Heidenstecker	Heide	UNV	N
Heidenstein	Heide	Glaube	N
Heidenstieg	Heide	Glaube	N
Heidenstolz	Heide	Intensität	Y
Heidenstrasse	Heide	Glaube	N
Heidenstraße	Heide	Glaube	N
Heidenstress	Heide	Intensität	Y
Heidenstube	Heide	Glaube	N
Heidensymbol	Heide	Glaube	N
Heiden-Symbolik	Heide	Glaube	N
Heidenszene	Heide	Glaube	N
Heidentaufe	Heide	Glaube	N
Heidentäufer	Heide	Glaube	N
Heiden-Teil	Heide	Intensität	Y
Heidentempo	Heide	Intensität	Y
Heidentheater	Heide	Intensität	Y
Heidentore	Heide	Glaube	N
Heidentöten	Heide	Glaube	N
Heidentradition	Heide	Glaube	N
Heidentürmchen	Heide	Glaube	N
Heidenturm	Heide	Glaube	N
Heidenüberraschung	Heide	Intensität	Y
Heidenumsatz	Heide	Intensität	Y
Heidenunrat	Heide	Intensität	Y
Heidenverehrer	Heide	Glaube	N
Heidenverfolgung	Heide	Glaube	N
Heidenvergnügen	Heide	Intensität	Y
Heidenverlag	Heide	Glaube	N
Heidenvölker	Heide	Glaube	N
Heidenvolk	Heide	Glaube	N
Heidenwahn	Heide	Glaube	N
Heidenwall	Heide	Glaube	N
Heidenweib	Heide	Glaube	N
Heiden-Welt	Heide	Glaube	N
Heidenwerfen	Heide	Glaube	N
Heidenwerk	Heide	Glaube	N
Heidenwirt	Heide	Glaube	N
Heidenwochenende	Heide	Glaube	N
Heidenwut	Heide	Intensität	Y
Heidenzeiten	Heide	Glaube	N
Heidenzeit	Heide	Intensität	Y
Heidenzorn	Heide	Intensität	Y
Jahrhundertabstand	Jahrhundert	Zeitraum	N
Jahrhundert-Alben	Jahrhundert	Bemerkenswertes	Y
Jahrhundertalent	Jahrhundert	Bemerkenswertes	Y
Jahrhundertangabe	Jahrhundert	Zeitraum	N
Jahrhundert-Athletin	Jahrhundert	Bemerkenswertes	Y
Jahrhundert-Attentat	Jahrhundert	Bemerkenswertes	Y
Jahrhundertaufgabe	Jahrhundert	Bemerkenswertes	Y
Jahrhundertaufzeichnungen	Jahrhundert	Zeitraum	N
Jahrhundertaugust	Jahrhundert	Bemerkenswertes	Y
Jahrhundertausgabe	Jahrhundert	Bemerkenswertes	Y
Jahrhundertausgang	Jahrhundert	Zeitraum	N
Jahrhundertausklang	Jahrhundert	Zeitraum	N
Jahrhundertauswahl	Jahrhundert	Bemerkenswertes	Y
Jahrhundertautor	Jahrhundert	Bemerkenswertes	Y
Jahrhundert-Baby	Jahrhundert	Bemerkenswertes	Y
Jahrhundertbaisse	Jahrhundert	Bemerkenswertes	Y
Jahrhundertbau	Jahrhundert	Bemerkenswertes	Y
Jahrhundertbegabung	Jahrhundert	Bemerkenswertes	Y
Jahrhundertbeginn	Jahrhundert	Zeitraum	N
Jahrhundertbegriff	Jahrhundert	Zeitraum	N
Jahrhundertbesuch	Jahrhundert	Bemerkenswertes	Y
Jahrhundertbetrachtung	Jahrhundert	Zeitraum	N
Jahrhundertbetrug	Jahrhundert	Bemerkenswertes	Y
Jahrhundertbilanz	Jahrhundert	Zeitraum	N
Jahrhundertblamage	Jahrhundert	Bemerkenswertes	Y
Jahrhundert-Bücher	Jahrhundert	Bemerkenswertes	Y
Jahrhundertbyte	Jahrhundert	Zeitraum	N
Jahrhundert-Cellist	Jahrhundert	Bemerkenswertes	Y
Jahrhundertchirurg	Jahrhundert	Bemerkenswertes	Y
Jahrhundertchronik	Jahrhundert	Zeitraum	N
Jahrhundertcollage	Jahrhundert	Zeitraum	N
Jahrhundertdeal	Jahrhundert	Bemerkenswertes	Y
Jahrhundertdenkmal	Jahrhundert	Zeitraum	N
Jahrhundertdeutscher	Jahrhundert	Bemerkenswertes	Y
Jahrhundertdrama	Jahrhundert	Bemerkenswertes	Y
Jahrhundertdurchschnitt	Jahrhundert	Zeitraum	N
Jahrhundert-Edition	Jahrhundert	Bemerkenswertes	Y
Jahrhundert-El-Nino	Jahrhundert	Bemerkenswertes	Y
Jahrhundertende	Jahrhundert	Zeitraum	N
Jahrhundertentdeckung	Jahrhundert	Bemerkenswertes	Y
Jahrhundertentwicklung	Jahrhundert	Bemerkenswertes	Y
Jahrhundertenwende	Jahrhundert	Zeitraum	N
Jahrhundert-Erdbeben	Jahrhundert	Bemerkenswertes	Y
Jahrhunderterfindung	Jahrhundert	Bemerkenswertes	Y
Jahrhunderterfolg	Jahrhundert	Bemerkenswertes	Y
Jahrhunderterinnerung	Jahrhundert	Zeitraum	N
Jahrhundert-Fahrer	Jahrhundert	Bemerkenswertes	Y
Jahrhundert-Februar	Jahrhundert	Bemerkenswertes	Y
Jahrhundertfeier	Jahrhundert	Zeitraum	N
Jahrhundert-Feldzug	Jahrhundert	Bemerkenswertes	Y
Jahrhundertfest	Jahrhundert	Zeitraum	N
Jahrhundertfeuerwerk	Jahrhundert	Bemerkenswertes	Y
Jahrhundert-Figur	Jahrhundert	Bemerkenswertes	Y
Jahrhundert-Film	Jahrhundert	Bemerkenswertes	Y
Jahrhundertflopp	Jahrhundert	Bemerkenswertes	Y
Jahrhundertflugzeug	Jahrhundert	Bemerkenswertes	Y
Jahrhundert-Flut	Jahrhundert	Bemerkenswertes	Y
Jahrhundertformel	Jahrhundert	Bemerkenswertes	Y
Jahrhundertfotograf	Jahrhundert	Bemerkenswertes	Y
Jahrhundertfrage	Jahrhundert	Bemerkenswertes	Y
Jahrhundertfrost	Jahrhundert	Bemerkenswertes	Y
Jahrhundertfund	Jahrhundert	Bemerkenswertes	Y
Jahrhundert-Fußballer	Jahrhundert	Bemerkenswertes	Y
Jahrhundertgärtner	Jahrhundert	Bemerkenswertes	Y
Jahrhundertgedächtnis	Jahrhundert	Zeitraum	N
Jahrhundertgedicht	Jahrhundert	Bemerkenswertes	Y
Jahrhundertgeheimnis	Jahrhundert	Bemerkenswertes	Y
Jahrhundertgeiger	Jahrhundert	Bemerkenswertes	Y
Jahrhundertgelächter	Jahrhundert	Bemerkenswertes	Y
Jahrhundertgenie	Jahrhundert	Bemerkenswertes	Y
Jahrhundert-Geschäft	Jahrhundert	Bemerkenswertes	Y
Jahrhundertgeschichte	Jahrhundert	Zeitraum	N
Jahrhundertgesicht	Jahrhundert	Bemerkenswertes	Y
Jahrhundertgipfel	Jahrhundert	Bemerkenswertes	Y
Jahrhundert-Goldschatzfund	Jahrhundert	Bemerkenswertes	Y
Jahrhunderthälfte	Jahrhundert	Zeitraum	N
Jahrhunderthandballer	Jahrhundert	Bemerkenswertes	Y
Jahrhundertheld	Jahrhundert	Bemerkenswertes	Y
Jahrhunderthitze	Jahrhundert	Bemerkenswertes	Y
Jahrhunderthochwasser	Jahrhundert	Bemerkenswertes	Y
Jahrhundert-Hund	Jahrhundert	Bemerkenswertes	Y
Jahrhundert-Hurrikan	Jahrhundert	Bemerkenswertes	Y
Jahrhundert-Idol	Jahrhundert	Bemerkenswertes	Y
Jahrhundert-Ingenieur	Jahrhundert	Bemerkenswertes	Y
Jahrhundertirrtum	Jahrhundert	Bemerkenswertes	Y
Jahrhundertjahrgang	Jahrhundert	Bemerkenswertes	Y
Jahrhundertjubiläum	Jahrhundert	Zeitraum	N
Jahrhundertkardinal	Jahrhundert	Bemerkenswertes	Y
Jahrhundertkatastophe	Jahrhundert	Bemerkenswertes	Y
Jahrhundert-Katastrophe	Jahrhundert	Bemerkenswertes	Y
Jahrhundertkerl	Jahrhundert	Bemerkenswertes	Y
Jahrhundert-Killer	Jahrhundert	Bemerkenswertes	Y
Jahrhundertklassiker	Jahrhundert	Bemerkenswertes	Y
Jahrhundertkoalition	Jahrhundert	Bemerkenswertes	Y
Jahrhundertkoch	Jahrhundert	Bemerkenswertes	Y
Jahrhundert-Komet	Jahrhundert	Bemerkenswertes	Y
Jahrhundert-Komiker	Jahrhundert	Bemerkenswertes	Y
Jahrhundertkonkurrenz	Jahrhundert	Bemerkenswertes	Y
Jahrhundertkreis	Jahrhundert	Zeitraum	N
Jahrhundertkünstler	Jahrhundert	Bemerkenswertes	Y
Jahrhundertkünstlerin	Jahrhundert	Bemerkenswertes	Y
Jahrhundertläufer	Jahrhundert	Bemerkenswertes	Y
Jahrhundertleben	Jahrhundert	Bemerkenswertes	Y
Jahrhundert-Legende	Jahrhundert	Bemerkenswertes	Y
Jahrhundertlehrplan	Jahrhundert	Zeitraum	N
Jahrhundertliteratur	Jahrhundert	Bemerkenswertes	Y
Jahrhundertlohn	Jahrhundert	Zeitraum	N
Jahrhundertmagier	Jahrhundert	Bemerkenswertes	Y
Jahrhundertmarke	Jahrhundert	Bemerkenswertes	Y
Jahrhundertmedizin	Jahrhundert	Bemerkenswertes	Y
Jahrhundertmelodie	Jahrhundert	Bemerkenswertes	Y
Jahrhundertmensch	Jahrhundert	Bemerkenswertes	Y
Jahrhundertmenü	Jahrhundert	Bemerkenswertes	Y
Jahrhundert-Mittelwert	Jahrhundert	Zeitraum	N
Jahrhundert-Mitte	Jahrhundert	Zeitraum	N
Jahrhundert-Mord	Jahrhundert	Bemerkenswertes	Y
Jahrhundertmythos	Jahrhundert	Bemerkenswertes	Y
Jahrhundert-Nacht	Jahrhundert	Zeitraum	N
Jahrhundert-Orkan	Jahrhundert	Bemerkenswertes	Y
Jahrhundertphilosoph	Jahrhundert	Bemerkenswertes	Y
Jahrhundertphysiker	Jahrhundert	Bemerkenswertes	Y
Jahrhundertplan	Jahrhundert	Bemerkenswertes	Y
Jahrhundertpleite	Jahrhundert	Bemerkenswertes	Y
Jahrhundert-Pontifikat	Jahrhundert	Bemerkenswertes	Y
Jahrhundertprägung	Jahrhundert	Bemerkenswertes	Y
Jahrhundertproblem	Jahrhundert	Bemerkenswertes	Y
Jahrhundertprojekt	Jahrhundert	Bemerkenswertes	Y
Jahrhundertprozess	Jahrhundert	Bemerkenswertes	Y
Jahrhundert-Qualität	Jahrhundert	Bemerkenswertes	Y
Jahrhundertrecycling	Jahrhundert	Bemerkenswertes	Y
Jahrhundertregen	Jahrhundert	Bemerkenswertes	Y
Jahrhundertregenfall	Jahrhundert	Bemerkenswertes	Y
Jahrhundertreihe	Jahrhundert	Zeitraum	N
Jahrhundert-Rekord	Jahrhundert	Bemerkenswertes	Y
Jahrhundertringe	Jahrhundert	Zeitraum	N
Jahrhundert-Rückblick	Jahrhundert	Zeitraum	N
Jahrhundertsänger	Jahrhundert	Bemerkenswertes	Y
Jahrhundertsatire	Jahrhundert	Bemerkenswertes	Y
Jahrhundertschäden	Jahrhundert	Bemerkenswertes	Y
Jahrhundertschatz	Jahrhundert	Bemerkenswertes	Y
Jahrhundertschauspiel	Jahrhundert	Bemerkenswertes	Y
Jahrhundertschauspieler	Jahrhundert	Bemerkenswertes	Y
Jahrhundertschicksal	Jahrhundert	Bemerkenswertes	Y
Jahrhundertschlaf	Jahrhundert	Bemerkenswertes	Y
Jahrhundertschluß	Jahrhundert	Zeitraum	N
Jahrhundertschneesturm	Jahrhundert	Bemerkenswertes	Y
Jahrhundertschuld	Jahrhundert	Bemerkenswertes	Y
Jahrhundertschwindel	Jahrhundert	Bemerkenswertes	Y
Jahrhundertserie	Jahrhundert	Bemerkenswertes	Y
Jahrhundertshälfte	Jahrhundert	Zeitraum	N
Jahrhundertsignatur	Jahrhundert	Bemerkenswertes	Y
Jahrhundertsommer	Jahrhundert	Bemerkenswertes	Y
Jahrhundert-Song	Jahrhundert	Bemerkenswertes	Y
Jahrhundertsopranistin	Jahrhundert	Bemerkenswertes	Y
Jahrhundertspektakel	Jahrhundert	Bemerkenswertes	Y
Jahrhundertspiele	Jahrhundert	Bemerkenswertes	Y
Jahrhundert-Sportlerin	Jahrhundert	Bemerkenswertes	Y
Jahrhundertspruch	Jahrhundert	Bemerkenswertes	Y
Jahrhundertsprung	Jahrhundert	Bemerkenswertes	Y
Jahrhundertsregen	Jahrhundert	Bemerkenswertes	Y
Jahrhundertstar	Jahrhundert	Bemerkenswertes	Y
Jahrhundert-Steuerreform	Jahrhundert	Bemerkenswertes	Y
Jahrhundert-Story	Jahrhundert	Bemerkenswertes	Y
Jahrhundertstreik	Jahrhundert	Bemerkenswertes	Y
Jahrhundertstreit	Jahrhundert	Bemerkenswertes	Y
Jahrhundertsturm	Jahrhundert	Bemerkenswertes	Y
Jahrhundertsühne	Jahrhundert	Bemerkenswertes	Y
Jahrhunderttaifun	Jahrhundert	Bemerkenswertes	Y
Jahrhunderttakt	Jahrhundert	Zeitraum	N
Jahrhunderttalente	Jahrhundert	Bemerkenswertes	Y
Jahrhundertthema	Jahrhundert	Bemerkenswertes	Y
Jahrhunderttief	Jahrhundert	Bemerkenswertes	Y
Jahrhundert-Tor	Jahrhundert	Bemerkenswertes	Y
Jahrhundert-Tradition	Jahrhundert	Zeitraum	N
Jahrhundert-Trainer	Jahrhundert	Bemerkenswertes	Y
Jahrhundert-Treffen	Jahrhundert	Bemerkenswertes	Y
Jahrhunderttreffer	Jahrhundert	Bemerkenswertes	Y
Jahrhundertturm	Jahrhundert	Bemerkenswertes	Y
Jahrhundertüberblick	Jahrhundert	Zeitraum	N
Jahrhundertübergang	Jahrhundert	Zeitraum	N
Jahrhundertunwetter	Jahrhundert	Bemerkenswertes	Y
Jahrhundert-Unwort	Jahrhundert	Bemerkenswertes	Y
Jahrhundert-Utopie	Jahrhundert	Bemerkenswertes	Y
Jahrhundert-Veranstaltung	Jahrhundert	Bemerkenswertes	Y
Jahrhundertvererber	Jahrhundert	Bemerkenswertes	Y
Jahrhundert-Verwüstung	Jahrhundert	Bemerkenswertes	Y
Jahrhundertvorstellung	Jahrhundert	Bemerkenswertes	Y
Jahrhundertwechsel	Jahrhundert	Zeitraum	N
Jahrhundertwein	Jahrhundert	Bemerkenswertes	Y
Jahrhundertwelle	Jahrhundert	Bemerkenswertes	Y
Jahrhundert-Weltrekord	Jahrhundert	Bemerkenswertes	Y
Jahrhundertwenden	Jahrhundert	Zeitraum	N
Jahrhundertwende-Society	Jahrhundert	Zeitraum	N
Jahrhundertwende-Zeit	Jahrhundert	Zeitraum	N
Jahrhundertwiederentdeckung	Jahrhundert	Bemerkenswertes	Y
Jahrhundertwissenschaftler	Jahrhundert	Bemerkenswertes	Y
Jahrhundertwort	Jahrhundert	Bemerkenswertes	Y
Jahrhundertzeitzeuge	Jahrhundert	Zeitraum	N
Jahrhundertzeugin	Jahrhundert	Zeitraum	N
Jahrhundertziffer	Jahrhundert	Zeitraum	N
Jahrhundertzug	Jahrhundert	Bemerkenswertes	Y
Qualitaetsbewusstsein		Gütegrad	N
Qualitätenlehre	Qualität	Gütegrad	N
Qualitätsabbau	Qualität	Gütegrad	N
Qualitätsabteilung	Qualität	Gütegrad	N
Qualitätsaktie	Qualität	hoheGüte	Y
Qualitäts-Andon-System	Qualität	hoheGüte	Y
Qualitätsangelegenheit	Qualität	Gütegrad	N
Qualitätsansatz	Qualität	Gütegrad	N
Qualitäts-Arbeitsgruppe	Qualität	Gütegrad	N
Qualitätsarmatur	Qualität	hoheGüte	Y
Qualitäts-Audit	Qualität	Gütegrad	N
Qualitätsauditierung	Qualität	Gütegrad	N
Qualitätsaussage	Qualität	Gütegrad	N
Qualitätsbaustein	Qualität	Gütegrad	N
Qualitätsbauweise	Qualität	hoheGüte	Y
Qualitätsbedenken	Qualität	Gütegrad	N
Qualitätsbemessung	Qualität	Gütegrad	N
Qualitätsbericht	Qualität	Gütegrad	N
Qualitätsbeschaffenheit	Qualität	Gütegrad	N
Qualitätsbewertungskriterium	Qualität	Gütegrad	N
Qualitäts-Coach	Qualität	Gütegrad	N
Qualitätsdrang	Qualität	hoheGüte	Y
Qualitätsdruck	Qualität	Gütegrad	N
Qualitätsdübel	Qualität	hoheGüte	Y
Qualitätsdumping	Qualität	Gütegrad	N
Qualitätsebene	Qualität	Gütegrad	N
Qualitätseffekt	Qualität	Gütegrad	N
Qualitätsentscheidung	Qualität	Gütegrad	N
Qualitätsent­wicklung	Qualität	Gütegrad	N
Qualitätsentwicklungsplan	Qualität	Gütegrad	N
Qualitätsentwicklungsprogramm	Qualität	Gütegrad	N
Qualitätsentwicklungssystem	Qualität	Gütegrad	N
Qualitätsertrag	Qualität	hoheGüte	Y
Qualitätserweiterung	Qualität	Gütegrad	N
Qualitäts-Export	Qualität	hoheGüte	Y
Qualitätsfeuerwerk	Qualität	hoheGüte	Y
Qualitätsfilm	Qualität	hoheGüte	Y
Qualitätsfleisch	Qualität	hoheGüte	Y
Qualitätsfliese	Qualität	hoheGüte	Y
Qualitätsfluglinie	Qualität	hoheGüte	Y
Qualitätsfonds	Qualität	hoheGüte	Y
Qualitätsförderung	Qualität	Gütegrad	N
Qualitätsformat	Qualität	hoheGüte	Y
Qualitätsforscher	Qualität	Gütegrad	N
Qualitätsfoto	Qualität	hoheGüte	Y
Qualitätsfront	Qualität	Gütegrad	N
Qualitäts-Gang	Qualität	Gütegrad	N
Qualitätsgeige	Qualität	hoheGüte	Y
Qualitätsgemeinschaft	Qualität	Geschwindigkeit	N
Qualitätsgras	Qualität	hoheGüte	Y
Qualitätsgründung	Qualität	hoheGüte	Y
Qualitätshandschuhe	Qualität	hoheGüte	Y
Qualitätshelm	Qualität	hoheGüte	Y
Qualitätshierarchie	Qualität	Gütegrad	N
Qualitätshonig	Qualität	hoheGüte	Y
Qualitäts-IATA-Linien-Gesellschaft	Qualität	hoheGüte	Y
Qualitätsingenieur	Qualität	Gütegrad	N
Qualitätsinstitut	Qualität	Gütegrad	N
Qualitätskatalog	Qualität	hoheGüte	Y
Qualitäts-Kennzeichnung	Qualität	Gütegrad	N
Qualitätskonverter	Qualität	hoheGüte	Y
Qualitätskopf	Qualität	hoheGüte	Y
Qualitätskostengruppen	Qualität	Gütegrad	N
Qualitätskostenstruktur	Qualität	Gütegrad	N
Qualitätskrise	Qualität	Gütegrad	N
Qualitätskriterium	Qualität	Gütegrad	N
Qualitätslabor	Qualität	Gütegrad	N
Qualitätsladen	Qualität	hoheGüte	Y
Qualitätslevel	Qualität	Gütegrad	N
Qualitätslösung	Qualität	hoheGüte	Y
Qualitätsmanagementagentur	Qualität	Gütegrad	N
Qualitätsmanagementfragen	Qualität	Gütegrad	N
Qualitätsmanagementkonzept	Qualität	Gütegrad	N
Qualitätsmanagementprojekt	Qualität	Gütegrad	N
Qualitätsmanagementprozess	Qualität	Gütegrad	N
Qualitätsmanagementrichtlinie	Qualität	Gütegrad	N
Qualitätsmarathon	Qualität	Gütegrad	N
Qualitätsmargarine	Qualität	hoheGüte	Y
Qualitätsmatratze	Qualität	hoheGüte	Y
Qualitätsmesse	Qualität	Gütegrad	N
Qualitäts-Messer	Qualität	hoheGüte	Y
Qualitätsmesssystem	Qualität	Gütegrad	N
Qualitätsmetzgerei	Qualität	hoheGüte	Y
Qualitätsmetzger	Qualität	hoheGüte	Y
Qualitäts-Mindeststandard	Qualität	Gütegrad	N
Qualitäts-Minimalismus	Qualität	Gütegrad	N
Qualitätsmöbel	Qualität	hoheGüte	Y
Qualitätsmodem	Qualität	hoheGüte	Y
Qualitätsmotor	Qualität	hoheGüte	Y
Qualitätsnachweis	Qualität	Gütegrad	N
Qualitätspegel	Qualität	Gütegrad	N
Qualitätsphilosophie	Qualität	Gütegrad	N
Qualitätsplanungs-Methode	Qualität	Gütegrad	N
Qualitätsprinzip	Qualität	Gütegrad	N
Qualitätsprüfsystem	Qualität	Gütegrad	N
Qualitätsprüfung	Qualität	Gütegrad	N
Qualitätsradio	Qualität	hoheGüte	Y
Qualitätsrefugium	Qualität	hoheGüte	Y
Qualitätsregelkreis	Qualität	Gütegrad	N
Qualitäts-Reise	Qualität	hoheGüte	Y
Qualitäts-Ritterzelt	Qualität	hoheGüte	Y
Qualitätsrucksack	Qualität	hoheGüte	Y
Qualitätsrückschlüsse	Qualität	Gütegrad	N
Qualitätssaat	Qualität	hoheGüte	Y
Qualitätssache	Qualität	Gütegrad	N
Qualitätsschmiede	Qualität	hoheGüte	Y
Qualitätsschotter	Qualität	hoheGüte	Y
Qualitätssenkung	Qualität	Gütegrad	N
Qualitätssessel	Qualität	hoheGüte	Y
Qualitätssicherheitsüberwacher	Qualität	Gütegrad	N
Qualitätssicherungsaufwand	Qualität	Gütegrad	N
Qualitätssicherungs-Institut	Qualität	Gütegrad	N
Qualitätssicherungslabor	Qualität	Gütegrad	N
Qualitätssicherungsstandard	Qualität	Gütegrad	N
Qualitätssicherungverfahren	Qualität	Gütegrad	N
Qualitätssignal	Qualität	Gütegrad	N
Qualitätsspitze	Qualität	Gütegrad	N
Qualitätssprit	Qualität	hoheGüte	Y
Qualitäts-Sprung	Qualität	Gütegrad	N
Qualitätsstandard	Qualität	Gütegrad	N
Qualitäts-Störfaktor	Qualität	Gütegrad	N
Qualitätssturz	Qualität	Gütegrad	N
Qualitätssymbol	Qualität	Gütegrad	N
Qualitäts-Tageszeitung	Qualität	hoheGüte	Y
Qualitätstag	Qualität	hoheGüte	Y
Qualitätstester	Qualität	Gütegrad	N
Qualitäts-Tipp	Qualität	hoheGüte	Y
Qualitätstoren	Qualität	hoheGüte	Y
Qualitätstourismus	Qualität	hoheGüte	Y
Qualitätstrend	Qualität	Gütegrad	N
Qualitätstropfen	Qualität	hoheGüte	Y
Qualitätsüberblick	Qualität	Gütegrad	N
Qualitäts-Unterricht	Qualität	hoheGüte	Y
Qualitätsurlaubsland	Qualität	hoheGüte	Y
Qualitätsverbesserung	Qualität	Gütegrad	N
Qualitätsverschiebung	Qualität	Gütegrad	N
Qualitätsverschlankung	Qualität	Gütegrad	N
Qualitätsversprechen	Qualität	Gütegrad	N
Qualitätsvieh	Qualität	hoheGüte	Y
Qualitätsvögel	Qualität	hoheGüte	Y
Qualitätswanderweg	Qualität	hoheGüte	Y
Qualitätswäsche	Qualität	hoheGüte	Y
Qualitätswasserbett	Qualität	hoheGüte	Y
Qualitätsweg	Qualität	hoheGüte	Y
Qualitätsweingegend	Qualität	hoheGüte	Y
Qualitätsweingut	Qualität	hoheGüte	Y
Qualitätswein	Qualität	hoheGüte	Y
Qualitätswein-Konsument	Qualität	hoheGüte	Y
Qualitätsweinproduktion	Qualität	hoheGüte	Y
Qualitätsweizenanbau	Qualität	hoheGüte	Y
Qualitätswerft	Qualität	hoheGüte	Y
Qualitätswerke	Qualität	hoheGüte	Y
Qualitätswerkstatt	Qualität	hoheGüte	Y
Qualitätswerkstoff	Qualität	hoheGüte	Y
Qualitätswerkzeug	Qualität	hoheGüte	Y
Qualitätswert	Qualität	Gütegrad	N
Qualitätswesen	Qualität	Gütegrad	N
Qualitätswettbewerb	Qualität	Gütegrad	N
Qualitätswettstreit	Qualität	Gütegrad	N
Qualitätswinzer	Qualität	hoheGüte	Y
Qualitätswissenschaft	Qualität	Gütegrad	N
Qualitätswitze	Qualität	hoheGüte	Y
Qualitätswoche	Qualität	Gütegrad	N
Qualitätsworkshop	Qualität	Gütegrad	N
Qualitätswünsche	Qualität	Gütegrad	N
Qualitätswurf	Qualität	hoheGüte	Y
Qualitätsystem	Qualität	Gütegrad	N
Qualitätszahlen	Qualität	Gütegrad	N
Qualitäts­zeichen	Qualität	Gütegrad	N
Qualitätszeichenpolitik	Qualität	Gütegrad	N
Qualitätszeitalter	Qualität	Gütegrad	N
Qualitäts-Zeitung	Qualität	hoheGüte	Y
Qualitätszeitzone	Qualität	Gütegrad	N
Qualitätszenit	Qualität	Gütegrad	N
Qualitätszentrum	Qualität	Gütegrad	N
Qualitätszertifikat	Qualität	Gütegrad	N
Qualitätszertifizierung	Qualität	Gütegrad	N
Qualitätszielgruppe	Qualität	Gütegrad	N
Qualitätszielkonzept	Qualität	Gütegrad	N
Qualitätszielüberschreitung	Qualität	Gütegrad	N
Qualitätszielverordnung	Qualität	Gütegrad	N
Qualitätszigarette	Qualität	hoheGüte	Y
Qualitätszirkelbeauftragter	Qualität	Gütegrad	N
Qualitätszirkelprojekt	Qualität	Gütegrad	N
Qualitätszirkelsitzung	Qualität	Gütegrad	N
Qualitätszirkel-Sprecher	Qualität	Gütegrad	N
Qualitätszirkeltreffen	Qualität	Gütegrad	N
Qualitätszugang	Qualität	hoheGüte	Y
Qualitätszugewinn	Qualität	Gütegrad	N
Qualitätszug	Qualität	hoheGüte	Y
Qualitätszusage	Qualität	hoheGüte	Y
Qualitätszuschauer	Qualität	hoheGüte	Y
Qualitätszuschlag	Qualität	Gütegrad	N
Qualitätszustandsbericht	Qualität	Gütegrad	N
Qualitätszustellung	Qualität	hoheGüte	Y
Qualitätszutat	Qualität	hoheGüte	Y
Qualitätszuwachs	Qualität	Gütegrad	N
Qualitätszweifel	Qualität	Gütegrad	N
Qualitätszweig	Qualität	Gütegrad	N
Qualitäturteil	Qualität	Gütegrad	N
Qualtitätswein	Qualität	hoheGüte	N
Schweineabgase	Schwein	Tier	N
Schweineafter	Schwein	Tier	N
Schweine-Albtraum	Schwein	Tier	N
Schweinearschloch	Schwein	Obszönes	Y
Schweinearsch	Schwein	Tier	N
Schweineausbruch	Schwein	Tier	N
Schweineausstellung	Schwein	Tier	N
Schweinebammel	Schwein	Steigerung	Y
Schweinebändel	Schwein	Tier	N
Schweinebaron	Schwein	Tier	N
Schweine-Bauchspeicheldrüse	Schwein	Tier	N
Schweinebefreiung	Schwein	Tier	N
Schweinebein	Schwein	Tier	N
Schweinebesamung	Schwein	Tier	N
Schweinebesatz	Schwein	Tier	N
Schweinebesitzer	Schwein	Tier	N
Schweinebestand	Schwein	Tier	N
Schweinebetrieb	Schwein	Tier	N
Schweine-Bild	Schwein	Tier	N
Schweine-Bioprothese	Schwein	Tier	N
Schweineblut	Schwein	Tier	N
Schweineborstenpinsel	Schwein	Tier	N
Schweinebraten	Schwein	Tier	N
Schweinebräutigam	Schwein	Tier	N
Schweinebrett	Schwein	Tier	N
Schweinebrust	Schwein	Tier	N
Schweinecollagen	Schwein	Tier	N
Schweinecomix	Schwein	Tier	N
Schweine-Dasein	Schwein	Tier	N
Schweinedatenbank	Schwein	Tier	N
Schweinedickdarm	Schwein	Tier	N
Schweinediplom	Schwein	Tier	N
Schweinedomestikation	Schwein	Tier	N
Schweinedrama	Schwein	Tier	N
Schweinedusche	Schwein	Tier	N
Schweine-Eierstöcke	Schwein	Tier	N
Schweine-Eizelle	Schwein	Tier	N
Schweineembryo	Schwein	Tier	N
Schweineerwerb	Schwein	Tier	N
Schweineerzeugerring	Schwein	Tier	N
Schweineerzeuger	Schwein	Tier	N
Schweineesser	Schwein	Tier	N
Schweine-Extrakt	Schwein	Tier	N
Schweinefabrik	Schwein	Tier	N
Schweinefamilie	Schwein	Tier	N
Schweinefan	Schwein	Tier	N
Schweinefiletscheibe	Schwein	Tier	N
Schweinefleischeinlage	Schwein	Tier	N
Schweinefleisch-Erzeugung	Schwein	Tier	N
Schweinefleischexporteur	Schwein	Tier	N
Schweinefleisch-Fan	Schwein	Tier	N
Schweinefleisch	Schwein	Tier	N
Schweinefleisch-Verbot	Schwein	Tier	N
Schweineflüsterer	Schwein	Tier	N
Schweinefötus	Schwein	Tier	N
Schweinefrass	Schwein	Obszönes	Y
Schweinefrau	Schwein	Obszönes	Y
Schweinefüße	Schwein	Tier	N
Schweinefutter	Schwein	Tier	N
Schweinegedärm	Schwein	Tier	N
Schweinegedicht	Schwein	Tier	N
Schweinegehacktes	Schwein	Tier	N
Schweinegehirn	Schwein	Tier	N
Schweinegeld	Schwein	Steigerung	Y
Schweinegeschichte	Schwein	Steigerung	Y
Schweinegestalt	Schwein	Tier	N
Schweine-Gewebe	Schwein	Tier	N
Schweinegitter	Schwein	Tier	N
Schweine-Glück	Schwein	Steigerung	Y
Schweinegroßanlage	Schwein	Tier	N
Schweine-Gulaschs	Schwein	Tier	N
Schweinegülle	Schwein	Tier	N
Schweinehaare	Schwein	Tier	N
Schweinehalle	Schwein	Tier	N
Schweinehalter	Schwein	Tier	N
Schweinehaltung	Schwein	Tier	N
Schweinehändler	Schwein	Tier	N
Schweinehäuschen	Schwein	Tier	N
Schweinehaut	Schwein	Tier	N
Schweinehaxe	Schwein	Tier	N
Schweinehehälfte	Schwein	Tier	N
Schweineherz	Schwein	Tier	N
Schweinehirte	Schwein	Tier	N
Schweinehölle	Schwein	Tier	N
Schweinehund-Alarm	Schwein	Obszönes	Y
Schweinehüters	Schwein	Tier	N
Schweineidyll	Schwein	Tier	N
Schweine-Illustrationen	Schwein	Tier	N
Schweineinfluenza	Schwein	Tier	N
Schweineinnereien	Schwein	Tier	N
Schweine-Insel	Schwein	Tier	N
Schweineintensivhaltung	Schwein	Tier	N
Schweinejunges	Schwein	Tier	N
Schweinekadaver	Schwein	Tier	N
Schweinekatapult	Schwein	Tier	N
Schweinekauf	Schwein	Tier	N
Schweinekennzeichnung	Schwein	Tier	N
Schweinekiefer	Schwein	Tier	N
Schweineknecht	Schwein	Tier	N
Schweineknorpel	Schwein	Tier	N
Schweinekoben	Schwein	Tier	N
Schweinekober	Schwein	Tier	N
Schweinekolonie	Schwein	Tier	N
Schweinekontrakt	Schwein	Tier	N
Schweinekostüme	Schwein	Tier	N
Schweinekottlet	Schwein	Tier	N
Schweinekreatur	Schwein	Tier	N
Schweinekrieg	Schwein	Tier	N
Schweinelappen	Schwein	Tier	N
Schweinelendchen	Schwein	Tier	N
Schweine-Lexikon	Schwein	Tier	N
Schweinelippe	Schwein	Tier	N
Schweinelunge	Schwein	Tier	N
Schweinemagen	Schwein	Tier	N
Schweinemann	Schwein	Tier	N
Schweinemark	Schwein	Tier	N
Schweinemarkt	Schwein	Tier	N
Schweinemaske	Schwein	Tier	N
Schweinemastanlage	Schwein	Tier	N
Schweinemastbtrieb	Schwein	Tier	N
Schweine-Mäster	Schwein	Tier	N
Schweine-Mastplätze	Schwein	Tier	N
Schweinemast-Zentren	Schwein	Tier	N
Schweinemäuler	Schwein	Tier	N
Schweinemedaillon	Schwein	Tier	N
Schweinemedien	Schwein	Obszönes	Y
Schweinemedizin	Schwein	Tier	N
Schweinemetzger	Schwein	Tier	N
Schweinemilch	Schwein	Tier	N
Schweineminutensteak	Schwein	Tier	N
Schweinemotiv	Schwein	Tier	N
Schweinemumie	Schwein	Tier	N
Schweinemund	Schwein	Tier	N
Schweinemuseum	Schwein	Tier	N
Schweinenase	Schwein	Tier	N
Schweinenummer	Schwein	Obszönes	Y
Schweineobst	Schwein	Tier	N
Schweineorgan	Schwein	Tier	N
Schweineorgel	Schwein	UNV	N
Schweineorgie	Schwein	Obszönes	Y
Schweinepaar	Schwein	Tier	N
Schweinepanik	Schwein	Steigerung	Y
Schweineparadies	Schwein	Tier	N
Schweinepascha	Schwein	Tier	N
Schweinepest	Schwein	Tier	N
Schweinepferch	Schwein	Tier	N
Schweinepfote	Schwein	Tier	N
Schweinepraxis	Schwein	Tier	N
Schweinepreisverfall	Schwein	Tier	N
Schweinepriester	Schwein	Obszönes	Y
Schweineprodukt	Schwein	Tier	N
Schweinequäler	Schwein	Tier	N
Schweinereiter	Schwein	Obszönes	Y
Schweinerippe	Schwein	Tier	N
Schweineritt	Schwein	Tier	N
Schweineröllchen	Schwein	Tier	N
Schweinerotte	Schwein	Tier	N
Schweinerücken	Schwein	Tier	N
Schweinerüssel	Schwein	Tier	N
Schweinesand	Schwein	Tier	N
Schweineschäufele	Schwein	Tier	N
Schweineschlächterei	Schwein	Tier	N
Schweineschlächter	Schwein	Tier	N
Schweineschlegel	Schwein	Tier	N
Schweineschwänzel	Schwein	Tier	N
Schweineschwanzstechen	Schwein	Tier	N
Schweineschwartenchips	Schwein	Tier	N
Schweineschwarten	Schwein	Tier	N
Schweinesegment	Schwein	Tier	N
Schweineseite	Schwein	Obszönes	Y
Schweinesilo	Schwein	Tier	N
Schweineskandal	Schwein	Tier	N
Schweinesorte	Schwein	Tier	N
Schweine-Speck	Schwein	Tier	N
Schweinespezialberater	Schwein	Tier	N
Schweine-Spiel	Schwein	Tier	N
Schweine-Stammtisch	Schwein	Tier	N
Schweine-Suhlfest	Schwein	Tier	N
Schweinetanzmelodie	Schwein	Tier	N
Schweinetanz	Schwein	Tier	N
Schweineteilen	Schwein	Tier	N
Schweinetötung	Schwein	Tier	N
Schweinetransports	Schwein	Tier	N
Schweinetrog	Schwein	Tier	N
Schweinevideo	Schwein	Obszönes	Y
Schweinewaden	Schwein	Tier	N
Schweinewarzen	Schwein	Tier	N
Schweineweide	Schwein	Tier	N
Schweine-Weltmeisterschaft	Schwein	Tier	N
Schweinewürfel	Schwein	Tier	N
Schweinewürschte	Schwein	Tier	N
Schweinewürste	Schwein	Tier	N
Schweinezahl	Schwein	Tier	N
Schweinezählungen	Schwein	Tier	N
Schweinezählung	Schwein	Tier	N
Schweinezahn	Schwein	Tier	N
Schweinezelle	Schwein	Tier	N
Schweinezins	Schwein	Steigerung	Y
Schweinezuchtorganisation	Schwein	Tier	N
Schweinezüchtung	Schwein	Tier	N
Schweine-Zwerge	Schwein	Tier	N
Spitzenakteur	Spitze	Führung	N
Spitzenalternative	Spitze	Qualität	Y
Spitzenanalyst	Spitze	Qualität	Y
Spitzenanalytik	Spitze	Qualität	Y
Spitzenanlage	Spitze	Qualität	Y
Spitzen-Arbeitgeberverband	Spitze	Führung	N
SPITZENARCHITEKTUR		Qualität	Y
Spitzen-Atomwissenschaftler	Spitze	Qualität	Y
Spitzenauslese	Spitze	Qualität	Y
Spitzenausstellung	Spitze	Qualität	Y
Spitzenbariton	Spitze	Qualität	Y
Spitzen-Beamter	Spitze	Führung	N
Spitzenbeamtin	Spitze	Führung	N
Spitzenbeanspruchung	Spitze	Intensität	Y
Spitzenbegabung	Spitze	Intensität	Y
Spitzenbeispiel	Spitze	Qualität	Y
Spitzen-Belegungsrate	Spitze	Intensität	Y
Spitzenbereich	Spitze	Intensität	Y
Spitzenbergsteiger	Spitze	Qualität	Y
Spitzenberufung	Spitze	Führung	N
Spitzenbesatz	Spitze	Gewebe	N
Spitzenblatt	Spitze	Formation	N
Spitzenboot	Spitze	Qualität	Y
Spitzenborte	Spitze	Gewebe	N
Spitzen-Damen-Slip	Spitze	Gewebe	N
Spitzendarbietung	Spitze	Qualität	Y
Spitzendecke	Spitze	Gewebe	N
Spitzendoppel	Spitze	Qualität	Y
Spitzendownhiller	Spitze	Qualität	Y
Spitzenedition	Spitze	Qualität	Y
Spitzeneffekt	Spitze	Intensität	Y
Spitzeneinheit	Spitze	Qualität	Y
Spitzen-Entertainer	Spitze	Qualität	Y
Spitzenentwicklung	Spitze	Qualität	Y
Spitzenereignis	Spitze	Führung	N
Spitzen-Erinnerung	Spitze	Qualität	Y
Spitzenetage	Spitze	Führung	N
Spitzenfachverband	Spitze	Führung	N
Spitzen-Fahrer	Spitze	Qualität	Y
Spitzenfahrzeug	Spitze	Qualität	Y
Spitzen-Fakultät	Spitze	Qualität	Y
Spitzenfirma	Spitze	Qualität	Y
Spitzen-Flightcase	Spitze	Qualität	Y
Spitzen	Spitze	Formation	N
Spitzenformulierung	Spitze	Qualität	Y
Spitzenforscher	Spitze	Qualität	Y
Spitzen-Forschungsergebnis	Spitze	Qualität	Y
Spitzenforum	Spitze	Führung	N
Spitzen-Fotograf	Spitze	Qualität	Y
Spitzenfunktionär	Spitze	Führung	N
Spitzengefühl	Spitze	Qualität	Y
Spitzengenossin	Spitze	Führung	N
Spitzen-Geräte	Spitze	Qualität	Y
Spitzengliederung	Spitze	Führung	N
Spitzengolf	Spitze	Qualität	Y
Spitzengrafik	Spitze	Qualität	Y
Spitzengremium	Spitze	Führung	N
Spitzen-Handballteam	Spitze	Qualität	Y
Spitzen-Hardware	Spitze	Qualität	Y
Spitzenhochschule	Spitze	Qualität	Y
Spitzenholz	Spitze	Qualität	Y
Spitzenimpulsleistung	Spitze	Intensität	Y
Spitzenintensität	Spitze	Intensität	Y
Spitzenjazz	Spitze	Qualität	Y
Spitzenjournal	Spitze	Qualität	Y
Spitzenjunge	Spitze	Qualität	Y
Spitzenkader	Spitze	Qualität	Y
Spitzenkamerad	Spitze	Qualität	Y
Spitzenkämpferin	Spitze	Qualität	Y
Spitzenkandidatin	Spitze	Führung	N
Spitzenkanon	Spitze	Qualität	Y
Spitzenkeramik	Spitze	Qualität	Y
Spitzenklinik	Spitze	Qualität	Y
Spitzenklöpplerin	Spitze	Gewebe	N
Spitzen-Know-how	Spitze	Qualität	Y
Spitzen-Know-How	Spitze	Qualität	Y
Spitzenkoch	Spitze	Qualität	Y
Spitzenkollektion	Spitze	Gewebe	N
Spitzenkomödie	Spitze	Qualität	Y
Spitzenkompetenz	Spitze	Führung	N
Spitzen-Komponist	Spitze	Qualität	Y
Spitzenkonditorei	Spitze	Qualität	Y
Spitzenkonservierungstechnologie	Spitze	Qualität	Y
Spitzenkosten	Spitze	Intensität	Y
Spitzen-Kraft	Spitze	Qualität	Y
Spitzenkühler	Spitze	Qualität	Y
Spitzenkulturverband	Spitze	Führung	N
Spitzen-Lamm	Spitze	Qualität	Y
Spitzenlangläuferin	Spitze	Qualität	Y
Spitzenlaser	Spitze	Qualität	Y
Spitzenläufer	Spitze	Qualität	Y
Spitzenleistung	Spitze	Intensität	Y
Spitzenlicht	Spitze	Formation	N
Spitzenlösung	Spitze	Qualität	Y
Spitzen-Managerin	Spitze	Führung	N
Spitzenmandat	Spitze	Führung	N
Spitzen-Mann	Spitze	Qualität	Y
Spitzenmarke	Spitze	Qualität	Y
Spitzenmassage	Spitze	Qualität	Y
Spitzenmathematik	Spitze	Qualität	Y
Spitzenmenge	Spitze	Intensität	Y
Spitzen-Moderator	Spitze	Qualität	Y
Spitzenmuseum	Spitze	Qualität	Y
Spitzennews	Spitze	Qualität	Y
Spitzenöl	Spitze	Qualität	Y
Spitzenönologe	Spitze	Qualität	Y
Spitzenorganisa­tion	Spitze	Führung	N
Spitzenorganist	Spitze	Qualität	Y
Spitzenpart	Spitze	Qualität	Y
Spitzenparzelle	Spitze	Qualität	Y
Spitzenpferd	Spitze	Qualität	Y
Spitzenplatz	Spitze	Führung	N
Spitzen-Politikern	Spitze	Führung	N
Spitzenpolizist	Spitze	Qualität	Y
Spitzenpotential	Spitze	Intensität	Y
Spitzen-Potenzial	Spitze	Intensität	Y
Spitzenpower	Spitze	Intensität	Y
Spitzen-Preis	Spitze	Qualität	Y
Spitzenprofessor	Spitze	Qualität	Y
Spitzenprogramm	Spitze	Qualität	Y
Spitzenpro	Spitze	Qualität	Y
Spitzenpulk	Spitze	Führung	N
Spitzenquartett	Spitze	Qualität	Y
Spitzenradius	Spitze	Formation	N
Spitzenrating	Spitze	Intensität	Y
Spitzenreferee	Spitze	Qualität	Y
Spitzenrefinanzierungssatz	Spitze	Intensität	Y
Spitzenregulator	Spitze	Führung	N
Spitzenreisezeit	Spitze	Intensität	Y
Spitzenreiter	Spitze	Führung	N
Spitzenring	Spitze	Qualität	Y
Spitzenrock	Spitze	Gewebe	N
Spitzen-Rollenspiel	Spitze	Qualität	Y
Spitzenrosette	Spitze	Gewebe	N
Spitzen-Roter	Spitze	Qualität	Y
Spitzenrotwein	Spitze	Qualität	Y
Spitzenrunde	Spitze	Führung	N
Spitzenrüsche	Spitze	Gewebe	N
Spitzen-Schauspieltalent	Spitze	Qualität	Y
Spitzenscheibe	Spitze	Qualität	Y
Spitzen-Schiedsrichterin	Spitze	Qualität	Y
Spitzen-Schiedsrichter	Spitze	Qualität	Y
Spitzen-Schneeparty	Spitze	Qualität	Y
Spitzenschülerin	Spitze	Qualität	Y
Spitzenschwester	Spitze	Qualität	Y
Spitzensextett	Spitze	Führung	N
Spitzenshirt	Spitze	Gewebe	N
Spitzensignal	Spitze	Intensität	Y
Spitzensingle	Spitze	Qualität	Y
Spitzensite	Spitze	Qualität	Y
Spitzen-Sommer-Mitsing-Schunkel-Tequila	Spitze	Qualität	Y
Spitzen-Spieler	Spitze	Qualität	Y
Spitzenspiel	Spitze	Führung	N
Spitzenspion	Spitze	Qualität	Y
Spitzensportler	Spitze	Qualität	Y
Spitzenspringreiter	Spitze	Qualität	Y
Spitzensprinterin	Spitze	Qualität	Y
Spitzenstern	Spitze	Gewebe	N
Spitzenstickerei	Spitze	Gewebe	N
Spitzenstreifen	Spitze	Gewebe	N
Spitzenstrombedarf	Spitze	Intensität	Y
Spitzenstrom	Spitze	Intensität	Y
Spitzentauglichkeit	Spitze	Führung	N
Spitzentech­nologie	Spitze	Qualität	Y
Spitzentechnologie	Spitze	Qualität	Y
Spitzentee	Spitze	Qualität	Y
Spitzentennis	Spitze	Intensität	Y
Spitzen-Tennis	Spitze	Qualität	Y
Spitzentermin	Spitze	Führung	N
Spitzen-Treffen	Spitze	Führung	N
Spitzentropfen	Spitze	Qualität	Y
Spitzentruppe	Spitze	Qualität	Y
Spitzenumhang	Spitze	Gewebe	N
Spitzen-Universität	Spitze	Qualität	Y
Spitzen-Unparteiischer	Spitze	Qualität	Y
Spitzen-UN-Polizist	Spitze	Führung	N
Spitzenunternehmen	Spitze	Qualität	Y
Spitzenurlaub	Spitze	Qualität	Y
Spitzen­verband	Spitze	Führung	N
Spitzenverband	Spitze	Qualität	Y
Spitzenverbindung	Spitze	Führung	N
Spitzen-Verbrauch	Spitze	Intensität	Y
Spitzenverdiener	Spitze	Führung	N
Spitzenverein	Spitze	Qualität	Y
Spitzenverpflegung	Spitze	Qualität	Y
Spitzenvertrag	Spitze	Qualität	Y
Spitzenvertreter	Spitze	Führung	N
Spitzenvorbild	Spitze	Qualität	Y
Spitzenvotum	Spitze	Intensität	Y
Spitzenwaffe	Spitze	Qualität	Y
Spitzenwanderung	Spitze	Qualität	Y
Spitzenweg	Spitze	Qualität	Y
Spitzen-Weißwein	Spitze	Qualität	Y
Spitzenweite	Spitze	Intensität	Y
Spitzenwert	Spitze	Intensität	Y
Spitzenwissenschaftlerin	Spitze	Qualität	Y
Spitzen-Wissenschaftler	Spitze	Qualität	Y
Spitzenzahl	Spitze	Intensität	Y
Spitzenzentrum	Spitze	Formation	N
Spitzen-Zinssatz	Spitze	Intensität	Y
Spitzenzitat	Spitze	Qualität	Y
Traum-Abbild	Traum	Schlaf	N
Traum-Abitur	Traum	Wunsch	Y
Traum-Abschluss	Traum	Wunsch	Y
Traum-Abtastung	Traum	Schlaf	N
Traum-Abwehr	Traum	Wunsch	Y
Traum-Agentur	Traum	Wunsch	Y
Traum-Aktion	Traum	Wunsch	Y
Traumaktivität	Traum	Schlaf	N
Traum-Aktivurlaub	Traum	Wunsch	Y
Traumambiente	Traum	Wunsch	Y
Traumanblick	Traum	Wunsch	Y
Traumangestellter	Traum	Wunsch	Y
Traumaquarium	Traum	Wunsch	Y
Traumarbeiterin	Traum	Schlaf	N
Traum-Arbeitgeber	Traum	Wunsch	Y
Traum-Arbeit	Traum	Wunsch	Y
Traumarena	Traum	Wunsch	Y
Traumauffassung	Traum	Schlaf	N
Traumaufnahme	Traum	Wunsch	Y
Traumaugen	Traum	Wunsch	Y
Traumausbildung	Traum	Wunsch	Y
Traumauslegung	Traum	Schlaf	N
Traum-Auslotung	Traum	Schlaf	N
Traumausrüstung	Traum	Wunsch	Y
Traum-Ballerina	Traum	Wunsch	Y
Traumbegriff	Traum	Schlaf	N
Traumbeschäftigung	Traum	Wunsch	Y
Traumbewegung	Traum	Schlaf	N
Traum-Bewußtsein	Traum	Schlaf	N
Traum-Bike	Traum	Wunsch	Y
Traumblatt	Traum	Schlaf	N
Traumblau	Traum	Wunsch	Y
Traumblicke	Traum	Wunsch	Y
Traumbolide	Traum	UNV	N
Traumboot	Traum	Wunsch	Y
Traumbuch	Traum	Schlaf	N
Traumbündnis	Traum	Wunsch	Y
Traumbusen	Traum	Wunsch	Y
Traum-Chef	Traum	Wunsch	Y
Traumcuvée	Traum	Wunsch	Y
Traumdeuter	Traum	Schlaf	N
Traumdichtung	Traum	Schlaf	N
Traumdose	Traum	Schlaf	N
Traumduo	Traum	Wunsch	Y
Traumecke	Traum	Wunsch	Y
Traum-Ego	Traum	Schlaf	N
Traum-Ehe	Traum	Wunsch	Y
Traumeinschaltquote	Traum	Wunsch	Y
Traum-Eintopf	Traum	Wunsch	Y
Traumelefant	Traum	Schlaf	N
Traumentschlüsselung	Traum	Schlaf	N
Traumentstellung	Traum	Schlaf	N
Traumepisode	Traum	Schlaf	N
Traumerzählung	Traum	Schlaf	N
Traumerzeugung	Traum	Schlaf	N
Traumexperte	Traum	Schlaf	N
Traumexpreß	Traum	Wunsch	Y
Traumfalle	Traum	Schlaf	N
Traumfänger	Traum	Schlaf	N
Traumfang	Traum	Wunsch	Y
Traum-Figur	Traum	Wunsch	Y
Traumfilm	Traum	Wunsch	Y
Traum-Flugpreis	Traum	Wunsch	Y
Traumflug	Traum	Wunsch	Y
Traum-Frau	Traum	Wunsch	Y
Traumfreistoß	Traum	Wunsch	Y
Traum-Freizeitinsel	Traum	Wunsch	Y
Traumfrühlingstag	Traum	Wunsch	Y
Traumfußballer	Traum	Wunsch	Y
Traumgarten	Traum	Wunsch	Y
Traumgebäck	Traum	Wunsch	Y
Traumgebilde	Traum	Wunsch	Y
Traumgegend	Traum	Wunsch	Y
Traumgelaber	Traum	Schlaf	N
Traum-Geländewagen	Traum	Wunsch	Y
Traumgeschichte	Traum	Schlaf	N
Traumgewirk	Traum	Wunsch	Y
Traumgitarre	Traum	Wunsch	Y
Traumgraphik	Traum	Wunsch	Y
Traumgrundstück	Traum	Wunsch	Y
Traumhand	Traum	Wunsch	Y
Traumhandy	Traum	Wunsch	Y
Traumhaus	Traum	Wunsch	Y
Traumhöhe	Traum	Wunsch	Y
Traum-Hotel	Traum	Wunsch	Y
Traum-Hündin	Traum	Wunsch	Y
Traumideal	Traum	Wunsch	Y
Traumillusion	Traum	Schlaf	N
Traumimago	Traum	Schlaf	N
Trauminkarnation	Traum	Schlaf	N
Traum-Insel	Traum	Wunsch	Y
Traum-Interview-Partner	Traum	Wunsch	Y
Traumjahr	Traum	Wunsch	Y
Traumkater	Traum	Schlaf	N
Traumknutscherei	Traum	Wunsch	Y
Traumkobold	Traum	Schlaf	N
Traumkompositum	Traum	Schlaf	N
Traumkontinent	Traum	Wunsch	Y
Traumkonzert	Traum	Wunsch	Y
Traumkuchen	Traum	Wunsch	Y
Traumkünstlerin	Traum	Wunsch	Y
Traumkurs	Traum	Schlaf	N
Traumlaboratorium	Traum	Schlaf	N
Traumlandgerät	Traum	Schlaf	N
Traum-Lexikon	Traum	Schlaf	N
Traumlinie	Traum	Wunsch	Y
Traumlohn	Traum	Wunsch	Y
Traumlos	Traum	Wunsch	Y
Traummacher	Traum	Schlaf	N
Traummädchen	Traum	Wunsch	Y
Traummass	Traum	Wunsch	Y
Traummaus	Traum	Wunsch	Y
Traum-Meister	Traum	Schlaf	N
Traummembran	Traum	Wunsch	Y
Traummotiv	Traum	Schlaf	N
Traummotor	Traum	Wunsch	Y
Traummühle	Traum	Wunsch	Y
Traumnummer	Traum	Wunsch	Y
Traumoper	Traum	Wunsch	Y
Traumorten	Traum	Wunsch	Y
Traumpark	Traum	Wunsch	Y
Traumpartie	Traum	Wunsch	Y
Traum-Performance	Traum	Wunsch	Y
Traumpfad	Traum	Wunsch	Y
Traumpopsong	Traum	Wunsch	Y
Traumprojekt	Traum	Wunsch	Y
Traum-Punkband	Traum	Wunsch	Y
Traum-Puzzle	Traum	Schlaf	N
Traumquote	Traum	Wunsch	Y
Traumrasen	Traum	Wunsch	Y
Traum-Realität	Traum	Schlaf	N
Traumregal	Traum	Wunsch	Y
Traumregierung	Traum	Wunsch	Y
Traumregisseur	Traum	Wunsch	Y
Traum-Reihe	Traum	Wunsch	Y
Traumreiseland	Traum	Wunsch	Y
Traum-Reise	Traum	Wunsch	Y
Traumrolle	Traum	Wunsch	Y
Traumsaat	Traum	Schlaf	N
Traumschaum	Traum	Wunsch	Y
Traumschema	Traum	Schlaf	N
Traumschilderung	Traum	Schlaf	N
Traumschlag	Traum	Wunsch	Y
Traumschlange	Traum	Wunsch	Y
Traumschuluniform	Traum	Wunsch	Y
Traumseil	Traum	Schlaf	N
Traum-Semester	Traum	Wunsch	Y
Traumserie	Traum	Wunsch	Y
Traumservice	Traum	Wunsch	Y
Traumshooting	Traum	Wunsch	Y
Traumsiebs	Traum	Schlaf	N
Traumsofa	Traum	Wunsch	Y
Traumsphäre	Traum	Schlaf	N
Traumspringer	Traum	Wunsch	Y
Traumstadion	Traum	Wunsch	Y
Traumsteins	Traum	Schlaf	N
Traum-Stele	Traum	Schlaf	N
Traumstelle	Traum	Wunsch	Y
Traumstory	Traum	Wunsch	Y
Traumstrand	Traum	Wunsch	Y
Traumstrauß	Traum	Wunsch	Y
Traumstücke	Traum	Wunsch	Y
Traumsuse	Traum	UNV	N
Traumsymbol	Traum	Schlaf	N
Traumszenario	Traum	Wunsch	Y
Traumtagebuch	Traum	Schlaf	N
Traumtänzerei	Traum	Wunsch	Y
Traumtänzer	Traum	Wunsch	Y
Traumtechnik	Traum	Wunsch	Y
Traum-Theater	Traum	Wunsch	Y
Traumthematik	Traum	Schlaf	N
Traumtheoretiker	Traum	Schlaf	N
Traumtherapien	Traum	Schlaf	N
Traumthese	Traum	Schlaf	N
Traumtiefe	Traum	Schlaf	N
Traumtrip	Traum	Wunsch	Y
Traum-Tropeninsel	Traum	Wunsch	Y
Traumultra	Traum	Wunsch	Y
Traumuniversum	Traum	Schlaf	N
Traumunsinn	Traum	Schlaf	N
Traumursache	Traum	Schlaf	N
Traumvariation	Traum	Schlaf	N
Traumveranda	Traum	Wunsch	Y
Traumverkäufer	Traum	Schlaf	N
Traumvers	Traum	Wunsch	Y
Traum-Vocals	Traum	Wunsch	Y
Traumwagen	Traum	Wunsch	Y
Traum-Wald	Traum	Schlaf	N
Traumwandlerin	Traum	Schlaf	N
Traumwäscherei	Traum	Schlaf	N
Traumweinbar	Traum	Wunsch	Y
Traumwein	Traum	Wunsch	Y
Traumwelt	Traum	Schlaf	N
Traumwochenende	Traum	Wunsch	Y
Traumwölkchen	Traum	Wunsch	Y
Traum-Yoga	Traum	Schlaf	N
Traumzahl	Traum	Wunsch	Y
Traumzensur	Traum	Schlaf	N
Traumzentrum	Traum	Schlaf	N
Traumzins	Traum	Wunsch	Y
