Abfalldreck	Dreck	Schmutz	N
Abfuehrgott	Gott	Experte	Y
Abführgott	Gott	Experte	Y
Abgasdreck	Dreck	Schmutz	N
Abgeordnetenschweine	Schwein	Schimpfwort	Y
Abmahndreck	Dreck	niedrigeQualität	Y
Abrüstungsapostel	Apostel	Befürworter	Y
Abschaffungsapostel	Apostel	Befürworter	Y
Abstiegsdreck	Dreck	niedrigeQualität	Y
Abwaschdreck	Dreck	Schmutz	N
Abwasserdreck	Dreck	Schmutz	N
Abwehrikone	Ikone	Verkörperung	Y
Achsbolzen	Bolzen	Stift	N
Achsschenkelbolzen	Bolzen	Stift	N
Ackerdreck	Dreck	Schmutz	N
Adlerkönig	König	Monarch	N
Admingott	Gott	Experte	Y
Affendreck	Dreck	Kot	N
Affenkönig	König	Monarch	N
Afrikaapostel	Apostel	Religion	N
Afterapostel	Apostel	Religion	N
Ägypterkönig	König	Monarch	N
Aktienguru	Guru	Experte	Y
Alleingott	Gott	Religion	N
Allerheiligenikone	Ikone	Religion	N
Allmachtsgott	Gott	Religion	N
Alltagsdreck	Dreck	Schmutz	N
Alltagsikone	Ikone	Verkörperung	Y
Alpakahengst	Hengst	Tier	N
Alpendreck	Dreck	niedrigeQualität	Y
Alpenikone	Ikone	Verkörperung	Y
Alpenkönig	König	Wichtigkeit	Y
Alptraumikone	Ikone	Verkörperung	Y
Altschneedreck	Dreck	Schmutz	N
Aluminiumbolzen	Bolzen	Stift	N
Ameisenkönig	König	Monarch	N
Ampelgott	Gott	Religion	N
Amtshengst	Hengst	Mann	Y
Anabolikahengst	Hengst	Mann	Y
Anarchapostel	Apostel	Befürworter	Y
Andalusierhengst	Hengst	Tier	N
Angelguru	Guru	Experte	Y
Angriffsapostel	Apostel	Befürworter	Y
Angstbolzen	Bolzen	hohesMaß	N
Angsthasenapostel	Apostel	Befürworter	Y
Anhangsdreck	Dreck	niedrigeQualität	Y
Animierschwein	Schwein	Schimpfwort	Y
Ankerbolzen	Bolzen	Stift	N
Anleihenguru	Guru	Experte	Y
Anpassungsapostel	Apostel	Befürworter	Y
Anschlagbolzen	Bolzen	Stift	N
Anschlussbolzen	Bolzen	Stift	N
Anstandspapst	Papst	Autorität	Y
Antibiotikaschweine	Schwein	Tier	N
anti-gott	Gott	Religion	N
Antiguru	Guru	Experte	Y
Antiimperialistendreck	Dreck	niedrigeQualität	Y
Antimoralapostel	Apostel	Befürworter	Y
Antoniusschweine	Schwein	Tier	N
Anzughengst	Hengst	Mann	Y
Apfelguru	Guru	Experte	Y
Appaloosahengst	Hengst	Tier	N
Aquapapst	Papst	Autorität	Y
Araberhengst	Hengst	Tier	N
Arbeiterapostel	Apostel	Befürworter	Y
Arbeiterpapst	Papst	Autorität	Y
Arbeiterschwein	Schwein	Schimpfwort	Y
Arbeitshengst	Hengst	Mann	Y
Arbeitsikone	Ikone	Verkörperung	Y
Arbeitsmarktguru	Guru	Experte	Y
Architektenikone	Ikone	Verkörperung	Y
Architekturikone	Ikone	Verkörperung	Y
Architekturpapst	Papst	Autorität	Y
Armbrustbolzen	Bolzen	Projektil	N
Asbestpapst	Papst	Autorität	Y
Aschendreck	Dreck	Schmutz	N
Assyrerkönig	König	Monarch	N
Astralgott	Gott	Religion	N
Asylantenschwein	Schwein	Schimpfwort	Y
Atommülldreck	Dreck	Schmutz	N
Atompapst	Papst	Autorität	Y
Aufhängebolzen	Bolzen	Stift	N
Aufklärungsapostel	Apostel	Befürworter	Y
Aufklärungsikone	Ikone	Verkörperung	Y
Aufklärungspapst	Papst	Autorität	Y
Aufruhrgott	Gott	Religion	N
Aufstiegsgott	Gott	Experte	Y
Augendreck	Dreck	Schmutz	N
Augustbolzen	Bolzen	Fehlt	N
Ausbrecherkönig	König	Wichtigkeit	Y
Ausländerdreck	Dreck	niedrigeQualität	Y
Ausländerschweinen	Schwein	Schimpfwort	Y
Ausnahmehengst	Hengst	Tier	N
Ausreißerkönig	König	Wichtigkeit	Y
Ausreißerschwein	Schwein	Tier	N
Außenseiterpapst	Papst	Kirche	N
Auswurfbolzen	Bolzen	Stift	N
Authentizitätsapostel	Apostel	Befürworter	Y
Autogott	Gott	Experte	Y
autoguru	Guru	Experte	Y
Autokönig	König	Wichtigkeit	Y
Automobilikone	Ikone	Verkörperung	Y
Autopapst	Papst	Autorität	Y
Autorengott	Gott	Experte	Y
Babyschwein	Schwein	Tier	N
Bachpapst	Papst	Autorität	Y
Bäderkönig	König	Wichtigkeit	Y
Bahnsportikone	Ikone	Verkörperung	Y
Ballenbolzen	Bolzen	Stift	N
Balsamiergott	Gott	Experte	Y
Bambuspapst	Papst	Autorität	Y
Bänksterdreck	Dreck	niedrigeQualität	Y
Barberinipapst	Papst	Kirche	N
Barfußguru	Guru	Experte	Y
Barnevelderpapst	Papst	Autorität	Y
Barrashengst	Hengst	Mann	Y
Basiliskenkönig	König	Monarch	N
Basketballikone	Ikone	Verkörperung	Y
Baumgott	Gott	Religion	N
Baumpapst	Papst	Autorität	Y
Baustellendreck	Dreck	Schmutz	N
Bayernapostel	Apostel	Religion	N
Bayernkönig	König	Monarch	N
Beas-Satguru	Guru	UNV	N
Befestigungsbolzen	Bolzen	Stift	N
Beflissenheitsapostel	Apostel	Befürworter	Y
Befruchtungsguru	Guru	Experte	Y
Befruchtungspapst	Papst	Autorität	Y
Begründerhengst	Hengst	Tier	N
Behindertenschweine	Schwein	Schimpfwort	Y
Behördenhengst	Hengst	Mann	Y
Beihilfepapst	Papst	Autorität	Y
Benimmpapst	Papst	Autorität	Y
Benzinschwein	Schwein	Schimpfwort	Y
Beraterpapst	Papst	Autorität	Y
Berberhengst	Hengst	Tier	N
Bergikone	Ikone	Verkörperung	Y
Bergkönig	König	Wichtigkeit	Y
Bergschweinen	Schwein	Tier	N
Berufshengst	Hengst	Mann	Y
Beschwichtigungsapostel	Apostel	Befürworter	Y
Betriebswirtschaftsguru	Guru	Experte	Y
Betroffenheitsapostel	Apostel	Befürworter	Y
Bettlerkönig	König	Wichtigkeit	Y
Bewegungsguru	Guru	Experte	Y
Bewegungsikone	Ikone	Verkörperung	Y
Beziehungsguru	Guru	Experte	Y
Bezirksapostel	Apostel	Religion	N
Bhaisajyaguru	Guru	Religion	N
Bhaishavaguru	Guru	Religion	N
Biergartenguru	Guru	Experte	Y
Bierguru	Guru	Experte	Y
Bierkönig	König	Wichtigkeit	Y
Bierpapst	Papst	Autorität	Y
Bilanzenpapst	Papst	Autorität	Y
Bildikone	Ikone	Religion	N
Bildschirmpapst	Papst	Autorität	Y
Bildungsapostel	Apostel	Befürworter	Y
Bildungsikone	Ikone	Verkörperung	Y
Bildungspapst	Papst	Autorität	Y
Blasmusikpapst	Papst	Autorität	Y
Bleibolzen	Bolzen	Stift	N
Blitzbolzen	Bolzen	Stift	N
Blödsinnsapostel	Apostel	Befürworter	Y
Bluesrockikone	Ikone	Verkörperung	Y
Blutmischungsapostel	Apostel	Befürworter	Y
Bocksgott	Gott	Religion	N
Boersenguru	Guru	Experte	Y
Bogenpapst	Papst	Autorität	Y
Böhmenkönig	König	Monarch	N
Bohnenkönig	König	Monarch	N
Borghesepapst	Papst	Kirche	N
Borgiapapst	Papst	Kirche	N
Borlandschwein	Schwein	Tier	N
Börsenguru	Guru	Experte	Y
Börsenschweine	Schwein	Schimpfwort	Y
Borstenschwein	Schwein	Tier	N
Botengott	Gott	Religion	N
Boulevarddreck	Dreck	niedrigeQualität	Y
Bourbonenkönig	König	Monarch	N
Braunkohlendreck	Dreck	Schmutz	N
Brechbolzen	Bolzen	Stift	N
Bremsbolzen	Bolzen	Stift	N
Brillenapostel	Apostel	Befürworter	Y
Britenkönig	König	Monarch	N
Bronzebolzen	Bolzen	Stift	N
Bronzeschwein	Schwein	Tier	N
Browserdreck	Dreck	niedrigeQualität	Y
Brückenpapst	Papst	Autorität	Y
Brucknerguru	Guru	Experte	Y
Bücherpapst	Papst	Autorität	Y
Buchguru	Guru	Experte	Y
Buchschwein	Schwein	Tier	N
Buddlerguru	Guru	Experte	Y
Buddyikone	Ikone	Verkörperung	Y
Bügelbolzen	Bolzen	Stift	N
Bühnendreck	Dreck	Schmutz	N
Bühnengott	Gott	Experte	Y
Bühnenguru	Guru	Experte	Y
Bühnenhengst	Hengst	Mann	Y
Bundesgott	Gott	Religion	N
Bundessiegerhengst	Hengst	Tier	N
Bürgerkönig	König	Monarch	N
Bürgerrechtsikone	Ikone	Verkörperung	Y
Bürgerschwein	Schwein	Schimpfwort	Y
Burgunderkönig	König	Monarch	N
Bürohengst	Hengst	Mann	Y
Bürokratenhengst	Hengst	Mann	Y
Bürokratenschwein	Schwein	Schimpfwort	Y
Buschschweines	Schwein	Tier	N
Busenikone	Ikone	Verkörperung	Y
Businessguru	Guru	Experte	Y
Butterschwein	Schwein	Tier	N
Camarguehengst	Hengst	Tier	N
Cashguru	Guru	Experte	Y
Cembalopapst	Papst	Autorität	Y
Championhengst	Hengst	Tier	N
Chancengerechtigkeitsapostel	Apostel	Befürworter	Y
Charakterbolzen	Bolzen	hohesMaß	N
Charakterschweinen	Schwein	Schimpfwort	Y
Charmebolzen	Bolzen	hohesMaß	N
Chauvinistenhengst	Hengst	Mann	Y
Chauvischweine	Schwein	Schimpfwort	Y
Chefapostel	Apostel	Religion	N
Chefguru	Guru	Religion	N
Chefschwein	Schwein	Schimpfwort	Y
Chemiedreck	Dreck	Schmutz	N
Chemieschweine	Schwein	Schimpfwort	Y
Chietlerjungenschwein	Schwein	Tier	N
christengott	Gott	Religion	N
Christenpapst	Papst	Kirche	N
Christenschwein	Schwein	Schimpfwort	Y
Christgott	Gott	Religion	N
Christusikone	Ikone	Religion	N
Cocktailpapst	Papst	Autorität	Y
Comicguru	Guru	Experte	Y
Comicikone	Ikone	Verkörperung	Y
Comicpapst	Papst	Autorität	Y
Computerdreck	Dreck	niedrigeQualität	Y
Computerguru	Guru	Experte	Y
Computerpapst	Papst	Autorität	Y
Contentpapst	Papst	Autorität	Y
Corradohengst	Hengst	Tier	N
Cyberikone	Ikone	Verkörperung	Y
Dämonendreck	Dreck	niedrigeQualität	Y
Dämonengott	Gott	Religion	N
Dämonenkönig	König	Monarch	N
Dänenkönig	König	Monarch	N
Darmdreck	Dreck	Kot	N
Datenguru	Guru	Experte	Y
Datenmüllpapst	Papst	Autorität	Y
Deckhengst	Hengst	Tier	N
Dekadenzbolzen	Bolzen	hohesMaß	N
Deklamationsapostel	Apostel	Befürworter	Y
Demenzbolzen	Bolzen	hohesMaß	N
Deregulierungsapostel	Apostel	Befürworter	Y
DerMoralapostel	Apostel	Befürworter	Y
Designguru	Guru	Experte	Y
Designikone	Ikone	Verkörperung	Y
Deutschenapostel	Apostel	Religion	N
Dezemberdreck	Dreck	Schmutz	N
Diätapostel	Apostel	Befürworter	Y
Diätguru	Guru	Experte	Y
Dichtergott	Gott	Experte	Y
Dichterikone	Ikone	Verkörperung	Y
Dichterkönig	König	Wichtigkeit	Y
Dichterpapst	Papst	Autorität	Y
Dichtungspapst	Papst	Autorität	Y
Dieseldreck	Dreck	Schmutz	N
Dieselpapst	Papst	Autorität	Y
Dieselschweine	Schwein	Schimpfwort	Y
Dimetikone	Ikone	UNV	N
Diplomatenpapsts	Papst	Kirche	N
Discounter-dreck	Dreck	niedrigeQualität	Y
Diskohengst	Hengst	Mann	Y
Dohlendreck	Dreck	Kot	N
Donaupapst	Papst	Autorität	Y
Donnerbolzen	Bolzen	Projektil	N
Donnergott	Gott	Religion	N
Doofbolzen	Bolzen	hohesMaß	N
Doppelmoralapostel	Apostel	Befürworter	Y
Doppeltschwein	Schwein	Glück	N
Dorfapostel	Apostel	Religion	N
Dorfdreck	Dreck	Schmutz	N
Dorfgott	Gott	Religion	N
Dornenkönig	König	Monarch	N
Dorschkönig	König	Wichtigkeit	Y
Drachendreck	Dreck	Kot	N
Drachengott	Gott	Religion	N
Drachenkönig	König	Monarch	N
Drecksschwein	Schwein	Schimpfwort	Y
Drehbolzen	Bolzen	Stift	N
Drehbuchguru	Guru	Experte	Y
Drehbuchpapst	Papst	Autorität	Y
Drehzahlhengst	Hengst	Mann	Y
Dreifaltigkeitsikone	Ikone	Religion	N
Dreikönig	König	Monarch	N
Drei-Linien-Kreuzungsschwein	Schwein	Tier	N
Dressurhengst	Hengst	Tier	N
Dribbelgott	Gott	Experte	Y
Dribbelkönig	König	Wichtigkeit	Y
Driftikone	Ikone	Verkörperung	Y
Drogenapostel	Apostel	Befürworter	Y
Drogendreck	Dreck	niedrigeQualität	Y
Drogenguru	Guru	Experte	Y
Drogenkönig	König	Wichtigkeit	Y
Drogenschwein	Schwein	Tier	N
Drohgott	Gott	Religion	N
Dromedarhengst	Hengst	Tier	N
Druckbolzen	Bolzen	Stift	N
Druckschwein	Schwein	Schimpfwort	Y
Dschungelkönig	König	Wichtigkeit	Y
Dübelgott	Gott	Religion	N
Dulderpapst	Papst	Kirche	N
Dummbolzen	Bolzen	hohesMaß	N
Dummheitsapostel	Apostel	Befürworter	Y
Dunkelkammerpapst	Papst	Autorität	Y
Durchhaltedreck	Dreck	niedrigeQualität	Y
Durchhalteikone	Ikone	Verkörperung	Y
Durschnittsdreck	Dreck	niedrigeQualität	Y
Ebergott	Gott	Religion	N
Edelstahlbolzen	Bolzen	Stift	N
Effizienzapostel	Apostel	Befürworter	Y
Ehrenkönig	König	Monarch	N
Eichelschwein	Schwein	Tier	N
Eifersuchtsbolzen	Bolzen	hohesMaß	N
Einbrecherkönig	König	Wichtigkeit	Y
Einheitsapostel	Apostel	Befürworter	Y
Einheitsdreck	Dreck	niedrigeQualität	Y
Einheitsgott	Gott	Religion	N
Einhornhengst	Hengst	Tier	N
Einrastbolzen	Bolzen	Stift	N
Einsamkeitsapostel	Apostel	Befürworter	Y
Einwanderungsapostel	Apostel	Befürworter	Y
Eisenbahnkönig	König	Wichtigkeit	Y
Eisenbolzen	Bolzen	Stift	N
Eisenschweine	Schwein	Fehlt	N
Eisenstahlbolzen	Bolzen	Stift	N
Eitelkeitsikone	Ikone	Verkörperung	Y
Ekelbolzen	Bolzen	hohesMaß	N
Elbenkönig	König	Monarch	N
Elbenschweine	Schwein	Tier	N
Elefantenzuchtpapst	Papst	Autorität	Y
Elektronikpapst	Papst	Autorität	Y
Elfenkönig	König	Monarch	N
Elitehengst	Hengst	Tier	N
Emotionsbolzen	Bolzen	hohesMaß	N
Empfindlichkeits­apostel	Apostel	Befürworter	Y
Endzeitapostel	Apostel	Befürworter	Y
Endzeitguru	Guru	Religion	N
Endzeit-Sektenguru	Guru	Religion	N
Energiebolzen	Bolzen	hohesMaß	N
Energieguru	Guru	Experte	Y
Energiepapst	Papst	Autorität	Y
Energiesparschwein	Schwein	Tier	N
Engelpapst	Papst	Kirche	N
Engelspapst	Papst	Kirche	N
Engelspapsts	Papst	Kirche	N
Entertainmentikone	Ikone	Verkörperung	Y
Enthüllungsguru	Guru	Experte	Y
Entschleunigungsapostel	Apostel	Befürworter	Y
Entwicklerikone	Ikone	Verkörperung	Y
Entwicklungsdreck	Dreck	niedrigeQualität	Y
Erbgesundheitsapostel	Apostel	Befürworter	Y
Erbsenschwein	Schwein	Tier	N
Erdbeerikone	Ikone	Verkörperung	Y
Erfolgshengst	Hengst	Mann	Y
Erklärungsikone	Ikone	Verkörperung	Y
Erlenkönig	König	Monarch	N
Erlösergott	Gott	Religion	N
Ernährungsapostel	Apostel	Befürworter	Y
Ernährungsguru	Guru	Experte	Y
Ernährungspapst	Papst	Autorität	Y
Erotikikone	Ikone	Verkörperung	Y
Erotikpapst	Papst	Autorität	Y
Ersatzapostel	Apostel	Religion	N
Ersatzbolzen	Bolzen	Stift	N
Ersatzhengst	Hengst	Tier	N
Ersatzikone	Ikone	Verkörperung	Y
Ersatzkönig	König	Monarch	N
Erstapostel	Apostel	Religion	N
Erziehungsdreck	Dreck	niedrigeQualität	Y
Erziehungsguru	Guru	Experte	Y
Erziehungspapst	Papst	Autorität	Y
Eselhengst	Hengst	Tier	N
Eselsgott	Gott	Religion	N
Esoterikguru	Guru	Experte	Y
Etappenhengst	Hengst	Mann	Y
Ethikapostel	Apostel	Befürworter	Y
Eventpapst	Papst	Autorität	Y
Ewenkengott	Gott	Religion	N
Ewigkeitsgott	Gott	Religion	N
Exodusgott	Gott	Religion	N
Explosivbolzen	Bolzen	Stift	N
Exzenterbolzen	Bolzen	Stift	N
Facebook-dreck	Dreck	niedrigeQualität	Y
Fahrradlenkerbolzen	Bolzen	Stift	N
Falkengott	Gott	Religion	N
Familiendreck	Dreck	niedrigeQualität	Y
Familienikone	Ikone	Religion	N
Fangbolzen	Bolzen	Stift	N
Faschodreck	Dreck	niedrigeQualität	Y
Faschoschweine	Schwein	Schimpfwort	Y
Fashionikone	Ikone	Verkörperung	Y
Fastpapst	Papst	Kirche	N
Federbolzen	Bolzen	Stift	N
Federkönig	König	Monarch	N
feel-good-guru	Guru	Experte	Y
Feenkönig	König	Monarch	N
Fernsehgott	Gott	Experte	Y
Fernsehguru	Guru	Experte	Y
Festikone	Ikone	Religion	N
Festmachbolzen	Bolzen	Stift	N
Fetenguru	Guru	Experte	Y
Feuergott	Gott	Religion	N
Feuerkönig	König	Monarch	N
Fickschweine	Schwein	Schimpfwort	Y
Filmgott	Gott	Experte	Y
Filmguru	Guru	Experte	Y
Filmikone	Ikone	Verkörperung	Y
Filmlizenzdreck	Dreck	niedrigeQualität	Y
Filmpapst	Papst	Autorität	Y
Finanzguru	Guru	Experte	Y
Finanzierungsguru	Guru	Experte	Y
Firmenikone	Ikone	Verkörperung	Y
Fischdreck	Dreck	Schmutz	N
Fischerkönig	König	Wichtigkeit	Y
Fischkönig	König	Monarch	N
Fischpapst	Papst	Autorität	Y
Fitnessapostel	Apostel	Befürworter	Y
Fitnessgott	Gott	Experte	Y
Fitnessguru	Guru	Experte	Y
Fitnesspapst	Papst	Autorität	Y
Fjordhengst	Hengst	Tier	N
Flankengott	Gott	Experte	Y
Fleischkönig	König	Wichtigkeit	Y
Fleißapostel	Apostel	Befürworter	Y
Flexibilitätsapostel	Apostel	Befürworter	Y
Fliegendreck	Dreck	Schimpfwort	N
Fliegengott	Gott	Religion	N
Fliegergott	Gott	Experte	Y
Fliegerinnenikone	Ikone	Verkörperung	Y
Flirtgott	Gott	Experte	Y
Fluggott	Gott	Experte	Y
Flugzeugikone	Ikone	Verkörperung	Y
Flussdreck	Dreck	Schmutz	N
Flusskönig	König	Monarch	N
Flußkönig	König	Monarch	N
Fohlenhengst	Hengst	Tier	N
Folgedreck	Dreck	Schmutz	N
Folksongikone	Ikone	Verkörperung	Y
forengott	Gott	Experte	Y
Fortschrittsapostel	Apostel	Befürworter	Y
Forumsgott	Gott	Experte	Y
Fotografieikone	Ikone	Verkörperung	Y
Frankenapostel	Apostel	Religion	N
Frankenkönig	König	Monarch	N
Frankenschweins	Schwein	Schimpfwort	Y
Franzosenhengst	Hengst	Tier	N
Frauenikone	Ikone	Verkörperung	Y
Freihandelsapostel	Apostel	Befürworter	Y
Freihandelspapst	Papst	Autorität	Y
Freiheitsapostel	Apostel	Befürworter	Y
Freiheitsikone	Ikone	Verkörperung	Y
Freistoßgott	Gott	Experte	Y
Freizeitpapst	Papst	Autorität	Y
Fresspapst	Papst	Autorität	Y
Freudengott	Gott	Religion	N
Friedenapostel	Apostel	Befürworter	Y
Friedensapostel	Apostel	Befürworter	Y
Friedenskönig	König	Monarch	N
Friedenspapst	Papst	Kirche	N
Friedhofsgott	Gott	Religion	N
Friesenapostel	Apostel	Religion	N
Friesenhengst	Hengst	Tier	N
Friesenpapst	Papst	Autorität	Y
Frisurenikone	Ikone	Verkörperung	Y
Frontikone	Ikone	Verkörperung	Y
Froschkönig	König	Monarch	N
Fructosegott	Gott	Experte	Y
Frustbolzen	Bolzen	hohesMaß	N
Fuchsgott	Gott	Religion	N
Fuchshengst	Hengst	Tier	N
Führerschwein	Schwein	Schimpfwort	Y
Führungsbolzen	Bolzen	Stift	N
Fundamentbolzen	Bolzen	Stift	N
Furchtikone	Ikone	Verkörperung	Y
Fußballapostel	Apostel	Befürworter	Y
Fußballguru	Guru	Experte	Y
Fussballikone	Ikone	Verkörperung	Y
Fußbodendreck	Dreck	Schmutz	N
Fussekguru	Guru	Experte	Y
GaLaguru	Guru	UNV	N
Gameguru	Guru	Experte	Y
Gangsterkönig	König	Wichtigkeit	Y
Gänsedreck	Dreck	Kot	N
Gartengott	Gott	Religion	N
Gastroguru	Guru	Experte	Y
Gebetsapostel	Apostel	Religion	N
Geborgenheitsapostel	Apostel	Befürworter	Y
Gebotsgott	Gott	Religion	N
Gebührenpapst	Papst	Autorität	Y
Gedankendreck	Dreck	niedrigeQualität	Y
Gefälligkeitsapostel	Apostel	Befürworter	Y
Gefühlsdreck	Dreck	niedrigeQualität	Y
Gegenikone	Ikone	Religion	N
Gegenkönig	König	Monarch	N
Gegenkulturikone	Ikone	Verkörperung	Y
Gegenpapste	Papst	Kirche	N
Gegenpapst	Papst	Kirche	N
Geheimpapst	Papst	Kirche	N
Geissdreck	Dreck	Kot	N
Geisterhengst	Hengst	Tier	N
Geisterkönig	König	Monarch	N
Geistesapostel	Apostel	Befürworter	Y
Gelddreck	Dreck	niedrigeQualität	Y
geld-gott	Gott	Experte	Y
Geldgott	Gott	Experte	Y
Geldguru	Guru	Experte	Y
Geldschwein	Schwein	Tier	N
Gelenkbolzen	Bolzen	Stift	N
Gemütsikone	Ikone	Verkörperung	Y
Gemütsschwein	Schwein	Schimpfwort	Y
Genieapostel	Apostel	Befürworter	Y
Genmaisdreck	Dreck	niedrigeQualität	Y
Genrekönig	König	Wichtigkeit	Y
Georgsikone	Ikone	Religion	N
Gerechtigkeitsapostel	Apostel	Befürworter	Y
Gerichtsdreck	Dreck	niedrigeQualität	Y
Germanenapostel	Apostel	Religion	N
Gesangsikone	Ikone	Verkörperung	Y
Geschmacksikone	Ikone	Verkörperung	Y
Geschmackspapst	Papst	Autorität	Y
Geschoßbolzen	Bolzen	Projektil	N
Gesellschaftshengst	Hengst	Mann	Y
Gesellschaftsikone	Ikone	Verkörperung	Y
Gesetzeshengst	Hengst	Mann	Y
Gestammeldreck	Dreck	niedrigeQualität	Y
Gestütshengst	Hengst	Tier	N
Gesundheitsapostel	Apostel	Befürworter	Y
Gesundheitsguru	Guru	Experte	Y
Gesundheitspapst	Papst	Autorität	Y
Gesunheitsapostel	Apostel	Befürworter	Y
Gewaltapostel	Apostel	Befürworter	Y
Gewaltfreiheitsapostel	Apostel	Befürworter	Y
Gewerbedreck	Dreck	Schmutz	N
Gewindebolzen	Bolzen	Stift	N
Gewißheitsapostel	Apostel	Befürworter	Y
Gewittergott	Gott	Religion	N
Gewohnheitsdreck	Dreck	niedrigeQualität	Y
Giftbolzen	Bolzen	Projektil	N
Giftgasguru	Guru	Experte	Y
Gipfelguru	Guru	Experte	Y
Giraffenhengst	Hengst	Tier	N
Gitarrendreck	Dreck	niedrigeQualität	Y
Gitarrenguru	Guru	Experte	Y
Gitarrenikone	Ikone	Verkörperung	Y
Glaspapst	Papst	Autorität	Y
Glatteisgott	Gott	Religion	N
Glatzengott	Gott	Experte	Y
Glaubensapostel	Apostel	Religion	N
Glaubenspapst	Papst	Kirche	N
Glaubwürdigkeitsikone	Ikone	Verkörperung	Y
Gleichberechtigungsapostel	Apostel	Befürworter	Y
Gleichheitsapostel	Apostel	Befürworter	Y
Gleitlagerpapst	Papst	Autorität	Y
Globalisierungsapostel	Apostel	Befürworter	Y
Glockenpapst	Papst	Autorität	Y
Glocknerkönig	König	Wichtigkeit	Y
Glücksschweine	Schwein	Tier	N
Goblinkönig	König	Monarch	N
Goldguru	Guru	Experte	Y
Goldhengst	Hengst	Tier	N
Goldschwein	Schwein	Tier	N
Goldwährungsapostel	Apostel	Befürworter	Y
Golfguru	Guru	Experte	Y
Gotenkönig	König	Monarch	N
Götterdreck	Dreck	niedrigeQualität	Y
Götterkönig	König	Monarch	N
Gottesapostel	Apostel	Religion	N
Gottesikone	Ikone	Religion	N
Gottkönig	König	Monarch	N
Grafikguru	Guru	Experte	Y
Grafitbolzen	Bolzen	Stift	N
Gralskönig	König	Monarch	N
Graphikikone	Ikone	Verkörperung	Y
Grenzgott	Gott	Religion	N
Griechengott	Gott	Religion	N
Großkönig	König	Monarch	N
Großstadtapostel	Apostel	Befürworter	Y
Großstadtdreck	Dreck	Schmutz	N
Großstadthengst	Hengst	Mann	Y
Gründerapostel	Apostel	Religion	N
Gründerhengst	Hengst	Tier	N
Grüntrinkerguru	Guru	Experte	Y
Gruppenguru	Guru	Religion	N
Gruselhengst	Hengst	Mann	Y
Gruselikone	Ikone	Verkörperung	Y
grüßgott	Gott	Religion	N
Gummibolzen	Bolzen	Stift	N
Gummidreck	Dreck	Schmutz	N
Gurkenkönig	König	Monarch	N
Gurkenpapst	Papst	Autorität	Y
guruguru	Guru	Experte	N
Gutmenschendreck	Dreck	niedrigeQualität	Y
Hackerikone	Ikone	Verkörperung	Y
Hafihengst	Hengst	Tier	N
Haflingerhengst	Hengst	Tier	N
Hahnenkönig	König	Monarch	N
Halbjahresikone	Ikone	Verkörperung	Y
Hallengott	Gott	Experte	Y
Haltbolzen	Bolzen	Stift	N
Haltebolzen	Bolzen	Stift	N
Halterungsbolzen	Bolzen	Stift	N
Hamsterdreck	Dreck	Kot	N
Handballikone	Ikone	Verkörperung	Y
Hangagott	Gott	Religion	N
Hängebauchschweins	Schwein	Tier	N
Hängebauschweine	Schwein	Tier	N
Hannoveranerhengst	Hengst	Tier	N
Haptagott	Gott	Religion	N
Hasenkönig	König	Monarch	N
Hassapostel	Apostel	Befürworter	Y
Hassbolzen	Bolzen	hohesMaß	N
Hastgott	Gott	Religion	N
Hauptapostel	Apostel	Religion	N
Hauptbolzen	Bolzen	Stift	N
Hauptikone	Ikone	Religion	N
Hauptprämienhengst	Hengst	Tier	N
Hauptprämiensiegerhengst	Hengst	Tier	N
Hauptschwein	Schwein	Tier	N
Hausfrauenikone	Ikone	Verkörperung	Y
Hausschwein	Schwein	Tier	N
Heavy-Metal-Gitarrengott	Gott	Experte	Y
Heerkönig	König	Monarch	N
Heidenapostel	Apostel	Religion	N
Heidenkönig	König	Monarch	N
Heilsapostel	Apostel	Befürworter	Y
Heilsguru	Guru	Religion	N
Heilskönig	König	Monarch	N
Heimwerkerkönig	König	Wichtigkeit	Y
Heizungsguru	Guru	Experte	Y
Heldengott	Gott	Religion	N
Herdgott	Gott	Religion	N
Herumbolzen	Bolzen	Fehlt	N
Herzkönig	König	Spiel	N
Hethiterkönig	König	Monarch	N
Hetzapostel	Apostel	Befürworter	Y
Hexenkönig	König	Monarch	N
Himmelfahrtsikone	Ikone	Religion	N
Himmelsgott	Gott	Religion	N
Himmelskönig	König	Monarch	N
Hirnbolzen	Bolzen	hohesMaß	N
hirtengott	Gott	Religion	N
Hirtenkönig	König	Monarch	N
Hitlergott	Gott	Religion	N
Hitparadendreck	Dreck	niedrigeQualität	Y
Hochkönig	König	Monarch	N
Hochleistungsschweine	Schwein	Tier	N
Hockeygott	Gott	Experte	Y
Höhenbolzen	Bolzen	Stift	N
Hohlbolzen	Bolzen	Stift	N
Höllenhengst	Hengst	Tier	N
Höllenkönig	König	Mann	N
Hollywoodikone	Ikone	Verkörperung	Y
Holsteinerhengst	Hengst	Tier	N
Holzbolzen	Bolzen	Stift	N
Holzikone	Ikone	Religion	N
Holzschwein	Schwein	Tier	N
Hormonbolzen	Bolzen	hohesMaß	N
Hormonpapst	Papst	Autorität	Y
Horrorikone	Ikone	Verkörperung	Y
Horrorpapst	Papst	Autorität	Y
Hörspielpapst	Papst	Autorität	Y
Hostapapst	Papst	Autorität	Y
Hotelikone	Ikone	Verkörperung	Y
Hühnerdreck	Dreck	Kot	N
Hülfsgott	Gott	Religion	N
Humanistenpapst	Papst	Kirche	N
Humanitätsapostel	Apostel	Befürworter	Y
Humorbolzen	Bolzen	hohesMaß	N
Humorhengst	Hengst	Mann	Y
Humorpapst	Papst	Autorität	Y
Hundedreck	Dreck	Kot	N
Hundeguru	Guru	Experte	Y
Hundekönig	König	Wichtigkeit	Y
Hunnenkönig	König	Monarch	N
Hüttenschweine	Schwein	Tier	N
Hybridikone	Ikone	Verkörperung	Y
Hygienepapst	Papst	Autorität	Y
Hypertextguru	Guru	Experte	Y
Ideologiebolzen	Bolzen	hohesMaß	N
Ideologiepapst	Papst	Autorität	Y
Idiotengott	Gott	Religion	N
Independentikone	Ikone	Verkörperung	Y
Indianerapostel	Apostel	Religion	N
Indieikone	Ikone	Verkörperung	Y
Industriedreck	Dreck	Schmutz	N
Industrieguru	Guru	Experte	Y
Industrieikone	Ikone	Verkörperung	Y
Industrieschwein	Schwein	Tier	N
Informationspapst	Papst	Autorität	Y
Informationswissenschaftspapst	Papst	Autorität	Y
Ingenieurgott	Gott	Experte	Y
Inhaltsikone	Ikone	Verkörperung	Y
Innerlichkeitsapostel	Apostel	Befürworter	Y
Innovationsbolzen	Bolzen	hohesMaß	N
Innovationsguru	Guru	Experte	Y
Insektendreck	Dreck	Schmutz	N
Inselkönig	König	Monarch	N
Instantdreck	Dreck	niedrigeQualität	Y
Integrationsapostel	Apostel	Befürworter	Y
Intelligenzbolzen	Bolzen	hohesMaß	N
Internetguru	Guru	Experte	Y
Intoleranzapostel	Apostel	Befürworter	Y
Investmentguru	Guru	Experte	Y
Investmentikone	Ikone	Verkörperung	Y
Investorenikone	Ikone	Verkörperung	Y
Islandhengst	Hengst	Tier	N
Jagadguru	Guru	Religion	N
Jagdgott	Gott	Religion	N
Jägergott	Gott	Religion	N
Jahresdreck	Dreck	Schmutz	N
Jahresgott	Gott	Religion	N
Jahrhundertpapst	Papst	Kirche	N
Jährlingshengst	Hengst	Tier	N
Jahrtausendpapst	Papst	Kirche	N
jasomirgott	Gott	Fehlt	N
Jazzpapst	Papst	Autorität	Y
Jelinekdreck	Dreck	niedrigeQualität	Y
Jenseitsapostel	Apostel	Befürworter	Y
Jochbolzen	Bolzen	Stift	N
Joggingpapst	Papst	Autorität	Y
Judenapostel	Apostel	Religion	N
Judenkönig	König	Monarch	N
Judenschweinen	Schwein	Schimpfwort	Y
Jugendapostel	Apostel	Religion	N
Jugendkönig	König	Wichtigkeit	Y
Jugendpapst	Papst	Kirche	N
Junghengst	Hengst	Tier	N
Jungschweines	Schwein	Tier	N
Juristenpapst	Papst	Autorität	Y
Juruguru	Guru	UNV	N
Justizschwein	Schwein	Schimpfwort	Y
Kabarettikone	Ikone	Verkörperung	Y
Kadunduguru	Guru	UNV	N
Käfergott	Gott	Religion	N
Kaffeeautomatenpapst	Papst	Autorität	Y
Kaffeedreck	Dreck	Schmutz	N
Kaffeekönig	König	Wichtigkeit	Y
Kaffeepapst	Papst	Autorität	Y
Kaltbluthengst	Hengst	Tier	N
Kältepapst	Papst	Autorität	Y
Kameldreck	Dreck	Kot	N
Kamelhengst	Hengst	Tier	N
Kampfesgott	Gott	Religion	N
Kampfgott	Gott	Religion	N
Kampfhundschwein	Schwein	Schimpfwort	Y
Kampfschwein	Schwein	Schimpfwort	Y
Kampfsportikone	Ikone	Verkörperung	Y
Kanaldreck	Dreck	Schmutz	N
Kaninchendreck	Dreck	Kot	N
Kapitalguru	Guru	Experte	Y
Kapitalismusapostel	Apostel	Befürworter	Y
Kapitalistenschwein	Schwein	Schimpfwort	Y
Kapphengst	Hengst	Tier	N
Karnevalskönig	König	Wichtigkeit	Y
Karottenkönig	König	Wichtigkeit	Y
Karpfenguru	Guru	Experte	Y
Karrierehengst	Hengst	Mann	Y
Kartoffeldreck	Dreck	Schmutz	N
Kartoffelkönig	König	Monarch	N
Kastenschwein	Schwein	Tier	N
Katastrophenapostel	Apostel	Befürworter	Y
Katharerpapst	Papst	Kirche	N
Katholikenschwein	Schwein	Schimpfwort	Y
Katzendreck	Dreck	Kot	N
Katzenschwein	Schwein	Tier	N
Kegelkönig	König	Wichtigkeit	Y
Kehrdreck	Dreck	Schmutz	N
Keifbolzen	Bolzen	hohesMaß	N
Keilschwein	Schwein	Tier	N
Kernbolzen	Bolzen	Stift	N
Kesselhengst	Hengst	Mann	Y
Kettenbolzen	Bolzen	Stift	N
Ketzerkönig	König	Monarch	N
Ketzerschweine	Schwein	Schimpfwort	Y
Kielbolzen	Bolzen	Stift	N
Kiezkönig	König	Wichtigkeit	Y
Killer-Wildschweinen	Schwein	Tier	N
Kinderkönig	König	Monarch	N
Kindkönig	König	Monarch	N
Kinohengst	Hengst	Mann	Y
Kirchenapostel	Apostel	Religion	N
Kirchenpapst	Papst	Kirche	N
Kitchdreck	Dreck	niedrigeQualität	Y
Kitschbolzen	Bolzen	hohesMaß	N
Klampfengott	Gott	Experte	Y
Klassehengst	Hengst	Tier	N
Klassenschwein	Schwein	Schimpfwort	Y
Klassenzusammenarbeitsapostel	Apostel	Befürworter	Y
Klassikerpapst	Papst	Autorität	Y
Klaviergott	Gott	Experte	Y
Klebebolzen	Bolzen	Stift	N
Klebedreck	Dreck	Schmutz	N
Kleinkönig	König	Monarch	N
Kleintierpapst	Papst	Autorität	Y
Kleinwagenikone	Ikone	Verkörperung	Y
Klempnergott	Gott	Experte	Y
Kletterguru	Guru	Experte	Y
Klimaapostel	Apostel	Befürworter	Y
Klonschweine	Schwein	Tier	N
Klopphengst	Hengst	Tier	N
Knabstrupperhengst	Hengst	Tier	N
Knappendreck	Dreck	niedrigeQualität	Y
Knochenpapst	Papst	Autorität	Y
Knuddelschwein	Schwein	Tier	N
Kohledreck	Dreck	Schmutz	N
Kohlrabiapostel	Apostel	Befürworter	Y
Koko-pok-guru	Guru	UNV	N
Kolbenbolzen	Bolzen	Stift	N
Kollegenschweine	Schwein	Schimpfwort	Y
Kommerzdreck	Dreck	niedrigeQualität	Y
Kommunenguru	Guru	Religion	N
Kommunikationsguru	Guru	Experte	Y
Komödiengott	Gott	Experte	Y
Komparsenschwein	Schwein	Schimpfwort	Y
Kompetenzbolzen	Bolzen	hohesMaß	N
Komponistenguru	Guru	Experte	Y
Konditionsbolzen	Bolzen	hohesMaß	N
Konfliktpapst	Papst	Autorität	Y
Konservierungsdreck	Dreck	Schmutz	N
Konsolendreck	Dreck	niedrigeQualität	Y
Konsumapostel	Apostel	Befürworter	Y
Konusbolzen	Bolzen	Stift	N
Konzertpapst	Papst	Autorität	Y
Konzilspapst	Papst	Kirche	N
Kopfbolzen	Bolzen	Stift	N
Koppelhengst	Hengst	Tier	N
Koptenpapst	Papst	Kirche	N
Koranapostel	Apostel	Religion	N
Körperdreck	Dreck	Schmutz	N
Körperguru	Guru	Experte	Y
Körperwelten-Ausstellungsguru	Guru	Experte	Y
Kortisonpapst	Papst	Autorität	Y
Krächzbolzen	Bolzen	hohesMaß	N
Kraftapostel	Apostel	Befürworter	Y
Kraftbolzen	Bolzen	hohesMaß	N
Krähenkönig	König	Monarch	N
Krankheitsdreck	Dreck	Schmutz	N
Kratzbolzen	Bolzen	hohesMaß	N
Kräuterpapst	Papst	Autorität	Y
Krautrockikone	Ikone	Verkörperung	Y
Kreativbolzen	Bolzen	hohesMaß	N
Kreativgott	Gott	Experte	Y
Kreativitätsguru	Guru	Experte	Y
Krebsgott	Gott	Experte	Y
Kreuzigungsikone	Ikone	Religion	N
Kreuzkopfbolzen	Bolzen	Stift	N
Kriegspapst	Papst	Kirche	N
Kritikerguru	Guru	Experte	Y
Kritikerpapst	Papst	Autorität	Y
Kritikpapst	Papst	Autorität	Y
Krokodilkönig	König	Monarch	N
Kryptoguru	Guru	Experte	Y
Kübeldreck	Dreck	Schmutz	N
Küchengott	Gott	Experte	Y
Kugelbolzen	Bolzen	Stift	N
Kugelguru	Guru	Experte	Y
Kühlerikone	Ikone	Verkörperung	Y
Kuhstalldreck	Dreck	Kot	N
Kultgott	Gott	Religion	N
Kultikone	Ikone	Verkörperung	Y
Kulturapostel	Apostel	Befürworter	Y
Kulturdreck	Dreck	niedrigeQualität	Y
Kulturkampfikone	Ikone	Verkörperung	Y
Kulturpapst	Papst	Autorität	Y
Kunstapostel	Apostel	Befürworter	Y
Kunstdreck	Dreck	niedrigeQualität	Y
Kunstfaserdreck	Dreck	niedrigeQualität	Y
Kunstguru	Guru	Experte	Y
Kunstikone	Ikone	Verkörperung	Y
Kunstpapst	Papst	Autorität	Y
Kunststoffbolzen	Bolzen	Stift	N
Kupferbolzen	Bolzen	Stift	N
Kuppelbolzen	Bolzen	Stift	N
Kupplungsbolzen	Bolzen	Stift	N
Kurbelwellenbolzen	Bolzen	Stift	N
Kürbiskönig	König	Wichtigkeit	Y
Kuschelguru	Guru	Experte	Y
Laborhengst	Hengst	Mann	Y
Laborschweine	Schwein	Tier	N
Lagerbolzen	Bolzen	Stift	N
Laienapostel	Apostel	Religion	N
Lamettahengst	Hengst	Mann	Y
Landesapostel	Apostel	Religion	N
Landesguru	Guru	Experte	Y
Landschweins	Schwein	Tier	N
Landwirtschaftsdreck	Dreck	Schmutz	N
Langlaufpapst	Papst	Autorität	Y
Langobardenkönig	König	Monarch	N
Lastengott	Gott	Religion	N
Lästerschwein	Schwein	Schimpfwort	Y
Latinohengst	Hengst	Mann	Y
Läuferikone	Ikone	Verkörperung	Y
Läuferschweine	Schwein	Tier	N
Laufguru	Guru	Experte	Y
Laufpapst	Papst	Autorität	Y
Lebensdreck	Dreck	niedrigeQualität	Y
Lebensmittelpapst	Papst	Autorität	Y
Lebensretterschwein	Schwein	Tier	N
Lederhosenguru	Guru	Experte	Y
Leibeigenschaftsapostel	Apostel	Befürworter	Y
Leidensgott	Gott	Religion	N
Leihhengst	Hengst	Tier	N
Leinwandikone	Ikone	Verkörperung	Y
Leistungsapostel	Apostel	Befürworter	Y
Leistungshengst	Hengst	Tier	N
Leithengst	Hengst	Tier	N
Leitikone	Ikone	Verkörperung	Y
Lesbenikone	Ikone	Verkörperung	Y
Lesekönig	König	Wichtigkeit	Y
Leuchtschweins	Schwein	Tier	N
Leuenkönig	König	UNV	N
Lichkönig	König	Monarch	N
Lichtapostel	Apostel	Religion	N
Liebesapostel	Apostel	Befürworter	Y
Liebesgott	Gott	Religion	N
Liebesschwein	Schwein	Tier	N
Lieblingsapostel	Apostel	Religion	N
Lieblingsgott	Gott	Religion	N
Lieblingshengst	Hengst	Tier	N
Lieblingsikone	Ikone	Religion	N
Lieblingspapst	Papst	Kirche	N
Lieblingsschwein	Schwein	Tier	N
Liederpapst	Papst	Autorität	Y
Limbogott	Gott	UNV	N
Linguistenpapst	Papst	Autorität	Y
Linienrichtergott	Gott	Experte	Y
Lipizzanerhengst	Hengst	Tier	N
Literaturikone	Ikone	Verkörperung	Y
Literaturpapst	Papst	Autorität	Y
Logistikpapst	Papst	Autorität	Y
Lohnzurückhaltungsapostel	Apostel	Befürworter	Y
Lottokönig	König	Wichtigkeit	Y
Löwengott	Gott	Religion	N
Löwenkönig	König	Monarch	N
Lückenfüllergott	Gott	Religion	N
Luderdreck	Dreck	niedrigeQualität	Y
Luftkönig	König	Monarch	N
Luftpapst	Papst	Autorität	Y
Lügenapostel	Apostel	Befürworter	Y
Lügenbolzen	Bolzen	hohesMaß	N
Lügendreck	Dreck	niedrigeQualität	Y
Lukasikone	Ikone	Religion	N
Lusitanohengst	Hengst	Tier	N
Lustbolzen	Bolzen	hohesMaß	N
Lusthengst	Hengst	Mann	Y
Luxusikone	Ikone	Verkörperung	Y
Lyderkönig	König	Monarch	N
Lyrikgott	Gott	Experte	Y
Lyrikikone	Ikone	Verkörperung	Y
Madonnenikone	Ikone	Religion	N
Makedonenkönig	König	Monarch	N
Malerschweins	Schwein	Schimpfwort	Y
Managementguru	Guru	Experte	Y
Mangalizaschwein	Schwein	Tier	N
Manierenpapst	Papst	Autorität	Y
Männerapostel	Apostel	Befürworter	Y
Männerikone	Ikone	Verkörperung	Y
Männlichkeitsikone	Ikone	Verkörperung	Y
Manöverdreck	Dreck	Schmutz	N
Märchenkönig	König	Monarch	N
Märchenpapst	Papst	Autorität	Y
Marienikone	Ikone	Religion	N
Marienpapst	Papst	Kirche	N
Marionettenpapst	Papst	Autorität	Y
Markenikone	Ikone	Verkörperung	Y
Markenschwein	Schwein	Schimpfwort	Y
Marketingdreck	Dreck	niedrigeQualität	Y
Marketingguru	Guru	Experte	Y
Marketingpapst	Papst	Autorität	Y
Marktapostel	Apostel	Befürworter	Y
Marktgott	Gott	Experte	Y
Markusikone	Ikone	Religion	N
Marmorapostel	Apostel	Religion	N
Marmorgott	Gott	Religion	N
Marzipanschweine	Schwein	Tier	N
Maskenguru	Guru	Experte	Y
Maskenschweinen	Schwein	Tier	N
Mäßigkeitsapostel	Apostel	Befürworter	Y
Mastschweins	Schwein	Tier	N
Maurenkönig	König	Monarch	N
Maurersdreck	Dreck	Schmutz	N
Mausdreck	Dreck	Kot	N
Mäusedreck	Dreck	Kot	N
Mausekönig	König	Monarch	N
Mäusekönig	König	Monarch	N
Meckerbolzen	Bolzen	hohesMaß	N
Medicipapst	Papst	Kirche	N
Medienapostel	Apostel	Befürworter	Y
Mediendreck	Dreck	niedrigeQualität	Y
Mediengott	Gott	Experte	Y
Medienguru	Guru	Experte	Y
Medienhengst	Hengst	Mann	Y
Medienpapst	Papst	Kirche	N
Medizinpapst	Papst	Autorität	Y
Meeresgott	Gott	Religion	N
Meereskönig	König	Monarch	N
Meerhengst	Hengst	Tier	N
Meerkönig	König	Monarch	N
Meerschweins	Schwein	Tier	N
Meinungsdreck	Dreck	niedrigeQualität	Y
Meinungshengst	Hengst	Mann	Y
Memoirendreck	Dreck	niedrigeQualität	Y
Menschenrechtsapostel	Apostel	Befürworter	Y
Menschheitsapostel	Apostel	Befürworter	Y
Menschschweine	Schwein	Tier	N
Merchandisedreck	Dreck	niedrigeQualität	Y
Merowingerkönig	König	Monarch	N
Messepapst	Papst	Autorität	Y
Messiaskönig	König	Monarch	N
Messingbolzen	Bolzen	Stift	N
Metallbolzen	Bolzen	Stift	N
Metallikone	Ikone	Religion	N
Metallschwein	Schwein	Tier	N
Milbendreck	Dreck	Kot	N
Militärikone	Ikone	Verkörperung	Y
Millionenhengst	Hengst	Tier	N
Minenguru	Guru	Experte	Y
Miniaturguru	Guru	Experte	Y
Minihengst	Hengst	Tier	N
Minischweinen	Schwein	Tier	N
Minischwein	Schwein	Tier	N
Ministeriumshengst	Hengst	Mann	Y
Minusgott	Gott	Religion	N
Mistapostel	Apostel	Befürworter	Y
Mistbolzen	Bolzen	hohesMaß	N
Mithrilbolzen	Bolzen	Projektil	N
Moabiterkönig	König	Monarch	N
Mobilitätsikone	Ikone	Verkörperung	Y
Möchtegernguru	Guru	Experte	Y
Möchtgernhengst	Hengst	Mann	Y
Modeguru	Guru	Experte	Y
Modeikone	Ikone	Verkörperung	Y
Modellbahnpapst	Papst	Autorität	Y
Modepapst	Papst	Autorität	Y
Modernisierungspapst	Papst	Autorität	Y
Modernitätsikone	Ikone	Verkörperung	Y
Moerderpapst	Papst	Kirche	N
Mohrenkönig	König	Monarch	N
Mönchsgott	Gott	Religion	N
Mönchspapst	Papst	Kirche	N
Monddreck	Dreck	Schmutz	N
Mondkönig	König	Monarch	N
Monsterdreck	Dreck	Schmutz	N
Montagebolzen	Bolzen	Stift	N
Moorkönig	König	Monarch	N
Moralapostel	Apostel	Befürworter	Y
Moralbolzen	Bolzen	hohesMaß	N
Moralpapst	Papst	Autorität	Y
Moralsapostel	Apostel	Befürworter	Y
Mormonenapostel	Apostel	Religion	N
Mörteldreck	Dreck	Schmutz	N
Mosaikikone	Ikone	Religion	N
Moslemdreck	Dreck	niedrigeQualität	Y
Motivationsguru	Guru	Experte	Y
Motorbefestigungsbolzen	Bolzen	Stift	N
Motorenpapst	Papst	Autorität	Y
Motorradhengst	Hengst	Mann	Y
Motorsportikone	Ikone	Verkörperung	Y
Mövendreck	Dreck	Kot	N
Möwendreck	Dreck	Kot	N
Mückendreck	Dreck	Kot	N
Müllkönig	König	Wichtigkeit	Y
Müllschwein	Schwein	Schimpfwort	Y
Multikultidreck	Dreck	niedrigeQualität	Y
Multimediapapst	Papst	Autorität	Y
Mumienkönig	König	Monarch	N
Musicalpapst	Papst	Autorität	Y
Musikantenkönig	König	Wichtigkeit	Y
Musikbolzen	Bolzen	hohesMaß	N
Musikdreck	Dreck	niedrigeQualität	Y
Musikerikone	Ikone	Verkörperung	Y
Musikgott	Gott	Experte	Y
Musikguru	Guru	Experte	Y
Musikikone	Ikone	Verkörperung	Y
Mustanghengst	Hengst	Tier	N
Mutterikone	Ikone	Verkörperung	Y
Mütterlichkeitsikone	Ikone	Verkörperung	Y
Mutterschweinen	Schwein	Tier	N
Nachbarschweinen	Schwein	Tier	N
Nachbarshengst	Hengst	Tier	N
Nachfrageapostel	Apostel	Befürworter	Y
Nachhaltigkeitsapostel	Apostel	Befürworter	Y
Nachkriegsdreck	Dreck	niedrigeQualität	Y
Nachrichtenikone	Ikone	Verkörperung	Y
Nachtclubhengst	Hengst	Mann	Y
Nachthengst	Hengst	UNV	N
Nachtlebenikone	Ikone	Verkörperung	Y
Nachwuchshengst	Hengst	Tier	N
Nacktikone	Ikone	Verkörperung	Y
Nageldreck	Dreck	Schmutz	N
Nahrungsgdreck	Dreck	niedrigeQualität	Y
Narrenbolzen	Bolzen	hohesMaß	N
Narrenkönig	König	Monarch	N
Narrenpapst	Papst	Autorität	Y
Nasenpapst	Papst	Autorität	Y
Nationalgott	Gott	Religion	N
Nationalikone	Ikone	Verkörperung	Y
Naturalistenpapst	Papst	Autorität	Y
Naturapostel	Apostel	Befürworter	Y
Naturgott	Gott	Religion	N
Natürlichkeitsapostel	Apostel	Befürworter	Y
Nazidreck	Dreck	niedrigeQualität	Y
Negativgott	Gott	Religion	N
Negerdreck	Dreck	niedrigeQualität	Y
Negerpapst	Papst	Kirche	N
Nervbolzen	Bolzen	hohesMaß	N
Nervenbolzen	Bolzen	hohesMaß	N
Netzapostel	Apostel	Befürworter	Y
Netzguru	Guru	Experte	Y
Netzwerkpapst	Papst	Autorität	Y
Neujahrsdreck	Dreck	Schmutz	N
Neutralitätsapostel	Apostel	Befürworter	Y
Nichtgott	Gott	Religion	N
Nichthengst	Hengst	Tier	N
Nichtschweine	Schwein	Tier	N
Nietbolzen	Bolzen	Stift	N
Nintendodreck	Dreck	niedrigeQualität	Y
Norikerhengst	Hengst	Tier	N
Normannenkönig	König	Monarch	N
Numiderkönig	König	Monarch	N
Nutzfahrzeugikone	Ikone	Verkörperung	Y
Nutzschweinen	Schwein	Tier	N
Oberbolzen	Bolzen	Stift	N
Oberflächendreck	Dreck	Schmutz	N
Oberguru	Guru	Experte	Y
Oberpapst	Papst	Autorität	Y
Oberschweine	Schwein	Schimpfwort	Y
Objektivapostel	Apostel	Befürworter	Y
Obstguru	Guru	Experte	Y
Oder-bolzen	Bolzen	UNV	N
Ofenpapst	Papst	Autorität	Y
Offenbarungsgott	Gott	Religion	N
Ökoapostel	Apostel	Befürworter	Y
Operettendreck	Dreck	niedrigeQualität	Y
Operettenkönig	König	Wichtigkeit	Y
Opfergott	Gott	Religion	N
Opferikone	Ikone	Religion	N
Orakelgott	Gott	Religion	N
Orakelschwein	Schwein	Tier	N
Orangeguru	Guru	Experte	Y
Orbitdreck	Dreck	Schmutz	N
Organisationsguru	Guru	Experte	Y
Organschwein	Schwein	Tier	N
Originaldreck	Dreck	niedrigeQualität	Y
Osterikone	Ikone	Religion	N
Osterschweinen	Schwein	Tier	N
Ostgotenkönig	Gott	Monarch	N
Otterkönig	König	Monarch	N
Pacellipapst	Papst	Kirche	N
Pachthengst	Hengst	Tier	N
Pädagogikpapst	Papst	Autorität	Y
Paddelpapst	Papst	Autorität	Y
Paidmaildreck	Dreck	niedrigeQualität	Y
Palominohengst	Hengst	Tier	N
Pampelschwein	Schwein	Tier	N
Panthergott	Gott	Religion	N
Panzerpapst	Papst	Autorität	Y
Papierkönig	König	Wichtigkeit	Y
Papierpapst	Papst	Autorität	Y
Paragrafenhengst	Hengst	Mann	Y
Parkinsonpapst	Papst	Autorität	Y
Parteibuchhengst	Hengst	Mann	Y
Parteiendreck	Dreck	niedrigeQualität	Y
Parteihengst	Hengst	Mann	Y
Parteilichkeitsapostel	Apostel	Befürworter	Y
Parteipapst	Papst	Autorität	Y
Partnerhengst	Hengst	Tier	N
Partyhengst	Hengst	Mann	Y
Partykönig	König	Wichtigkeit	Y
Passbolzen	Bolzen	Stift	N
Passivhauspapst	Papst	Autorität	Y
Patentdreck	Dreck	niedrigeQualität	Y
Patientenguru	Guru	Experte	Y
Patronatsikone	Ikone	Religion	N
Pegasushengst	Hengst	Tier	N
Peilbolzen	Bolzen	Stift	N
Penetranzbolzen	Bolzen	hohesMaß	N
Perserkönig	König	Monarch	N
Personengott	Gott	Religion	N
Petrolpapst	Papst	Autorität	Y
Pfeifbolzen	Bolzen	Projektil	N
Pfeifenpapst	Papst	Autorität	Y
Pferdedreck	Dreck	Kot	N
Pferdeguru	Guru	Experte	Y
Pferdehengst	Hengst	Tier	N
Pferdepapst	Papst	Autorität	Y
Pfingstapostel	Apostel	Religion	N
Pfingstdreck	Dreck	niedrigeQualität	Y
Pflegergott	Gott	UNV	N
Pfostenbolzen	Bolzen	Stift	N
Pfützendreck	Dreck	Schmutz	N
Pharmadreck	Dreck	niedrigeQualität	Y
Philosophengott	Gott	Experte	Y
Philosophenkönig	König	Wichtigkeit	Y
Phönixkönig	König	Monarch	N
Phrasenschwein	Schwein	Tier	N
Physikguru	Guru	Experte	Y
Physikpapst	Papst	Autorität	Y
Pilzbolzen	Bolzen	Stift	N
Pilzkönig	König	Monarch	N
Pilzpapst	Papst	Autorität	Y
Pintohengst	Hengst	Tier	N
Piratenkönig	König	Monarch	N
Piratenschwein	Schwein	Schimpfwort	Y
Pixelapostel	Apostel	Befürworter	Y
Pixeldreck	Dreck	niedrigeQualität	Y
Pixelpapst	Papst	Autorität	Y
Plasmabolzen	Bolzen	Projektil	N
Plastikbolzen	Bolzen	Stift	N
Plastikdreck	Dreck	niedrigeQualität	Y
Plastikikone	Ikone	Religion	N
Platinbolzen	Bolzen	Stift	N
Plättbolzen	Bolzen	Stift	N
Plattenapostel	Apostel	Befürworter	Y
Plattenpapst	Papst	Autorität	Y
Plüschschwein	Schwein	Tier	N
Polenkönig	König	Monarch	N
Polenpapst	Papst	Kirche	N
Politguru	Guru	Experte	Y
Politikguru	Guru	Experte	Y
Politikschweine	Schwein	Schimpfwort	Y
Polizeigott	Gott	Experte	Y
Polizistenschweine	Schwein	Schimpfwort	Y
Poltergott	Gott	Religion	N
Polygott	Gott	UNV	N
Pomadenhengst	Hengst	Mann	Y
Pommernapostel	Apostel	Religion	N
Popdichterikone	Ikone	Verkörperung	Y
Populärkulturguru	Guru	Experte	Y
Pornodreck	Dreck	niedrigeQualität	Y
Pornohengst	Hengst	Mann	Y
Pornokönig	König	Wichtigkeit	Y
Porzellangott	Gott	Religion	N
Porzellanschwein	Schwein	Tier	N
Possenkönig	König	Wichtigkeit	Y
Posterikone	Ikone	Verkörperung	Y
Potenzbolzen	Bolzen	hohesMaß	N
Potenzhengst	Hengst	Mann	Y
Prachthengst	Hengst	Tier	N
Prachtschweine	Schwein	Tier	N
Praktikantendreck	Dreck	niedrigeQualität	Y
Prämienhengst	Hengst	Tier	N
Preßbolzen	Bolzen	Stift	N
Presseschweine	Schwein	Schimpfwort	Y
Preußenkönig	König	Monarch	N
Preußenschwein	Schwein	Schimpfwort	Y
Priesterkönig	König	Monarch	N
Printpapste	Papst	Autorität	Y
Privatguru	Guru	Experte	Y
Privathengst	Hengst	Tier	N
Privilegienschwein	Schwein	Schimpfwort	Y
Probierhengst	Hengst	Tier	N
Produktionsgott	Gott	Experte	Y
Produzentengott	Gott	Experte	Y
Produzentenguru	Guru	Experte	Y
Programmiererschwein	Schwein	Schimpfwort	Y
Projektorenpapsts	Papst	Autorität	Y
Propellerhengst	Hengst	UNV	N
Protestschwein	Schwein	Tier	N
Prothesenpapst	Papst	Autorität	Y
Prozessikone	Ikone	Verkörperung	Y
Pseudoapostel	Apostel	Religion	N
Pseudopapst	Papst	Kirche	N
Psychiaterguru	Guru	Experte	Y
Psychoguru	Guru	Experte	Y
Psychologenpapst	Papst	Autorität	Y
Psychopathenschwein	Schwein	Schimpfwort	Y
Pudelkönig	König	Wichtigkeit	Y
Punkerschwein	Schwein	Schimpfwort	Y
Puppenkönig	König	Wichtigkeit	Y
Pustelschweine	Schwein	Tier	N
Quarterhengst	Hengst	Tier	N
Querbolzen	Bolzen	Stift	N
Querkraftbolzen	Bolzen	Stift	N
Quermutterbolzen	Bolzen	Stift	N
Quotenkönig	König	Wichtigkeit	Y
Quotenpapst	Papst	Autorität	Y
Rabengott	Gott	Religion	N
Rabenkönig	König	Monarch	N
Rachepapst	Papst	Autorität	Y
Radiogott	Gott	Experte	Y
Radioikone	Ikone	Verkörperung	Y
Radiopapst	Papst	Autorität	Y
Radsportikone	Ikone	Verkörperung	Y
Rappenhengst	Hengst	Tier	N
Rassehengst	Hengst	Tier	N
Rassistenschwein	Schwein	Schimpfwort	Y
Rationalisierungspapst	Papst	Autorität	Y
Rätselkönig	König	Wichtigkeit	Y
Rattendreck	Dreck	Kot	N
Rattengott	Gott	Monarch	N
Rattenkönig	König	Monarch	N
Ratzipapst	Papst	Kirche	N
Raubapostel	Apostel	Befürworter	Y
Raucherdreck	Dreck	Schmutz	N
Rechenkönig	König	Wichtigkeit	Y
Rechtsdreck	Dreck	niedrigeQualität	Y
Redeverbotsapostel	Apostel	Befürworter	Y
Reformapostel	Apostel	Befürworter	Y
Reformguru	Guru	Experte	Y
Reformpapst	Papst	Kirche	N
Reformpapsts	Papst	Kirche	N
Reformschweine	Schwein	Schimpfwort	Y
Regelhengst	Hengst	Mann	Y
Regelpapst	Papst	Autorität	Y
Regenkönig	König	Wichtigkeit	Y
Regieguru	Guru	Experte	Y
Reinheitsapostel	Apostel	Befürworter	Y
Reiseapostel	Apostel	Befürworter	Y
Reisedreck	Dreck	Schmutz	N
Reiseführergott	Gott	Experte	Y
Reiseguru	Guru	Experte	Y
Reisepapst	Papst	Kirche	N
Reithengst	Hengst	Tier	N
Reitpferdehengst	Hengst	Tier	N
Reitponyhengst	Hengst	Tier	N
Reitschwein	Schwein	Schimpfwort	Y
Reliefikone	Ikone	Religion	N
Religionsapostel	Apostel	Religion	N
Religionsdreck	Dreck	niedrigeQualität	Y
Remiskönig	König	Wichtigkeit	Y
Renaissancepapst	Papst	Kirche	N
Renegatenschweine	Schwein	Schimpfwort	Y
Rennfahrerikone	Ikone	Verkörperung	Y
Rentenpapst	Papst	Autorität	Y
Reserveschlagbolzen	Bolzen	Stift	N
Restdreck	Dreck	Schmutz	N
Rettungsguru	Guru	Experte	Y
Revierhengst	Hengst	Mann	Y
Rheinländerhengst	Hengst	Tier	N
Rhetorikguru	Guru	Experte	Y
Richtergott	Gott	Religion	N
Richterschwein	Schwein	Schimpfwort	Y
Riegelbolzen	Bolzen	Stift	N
Riesenbolzen	Bolzen	Stift	N
Riesenhengst	Hengst	Tier	N
Riesenkönig	König	Monarch	N
Riesenschwein	Schwein	Glück	N
Riffbolzen	Bolzen	Stift	N
Rindergott	Gott	Religion	N
Rindschweine	Schwein	Tier	N
Ringbolzen	Bolzen	Stift	N
Ringerikone	Ikone	Verkörperung	Y
Rinnsteindreck	Dreck	Schmutz	N
Ritzendreck	Dreck	Schmutz	N
Rockikone	Ikone	Verkörperung	Y
Rockpapst	Papst	Autorität	Y
Rockschwein	Schwein	Fehlt	N
Rohkostguru	Guru	Experte	Y
Rohkostpapst	Papst	Autorität	Y
Rollenhengst	Hengst	Mann	Y
Rollschweinen	Schwein	Tier	N
Rosenkönig	König	Wichtigkeit	Y
Rotlichtkönig	König	Wichtigkeit	Y
Rotorbolzen	Bolzen	Stift	N
Rotzdreck	Dreck	niedrigeQualität	Y
Rübenkönig	König	UNV	N
Ruhrgebietsikone	Ikone	Verkörperung	Y
Ruhrpottikone	Ikone	Verkörperung	Y
Rundbolzen	Bolzen	Stift	N
Rüsselschweine	Schwein	Tier	N
Russenhengst	Hengst	Tier	N
Russenikone	Ikone	Verkörperung	Y
Saatengott	Gott	Religion	N
Sachsenkönig	König	Monarch	N
Sachsenschwein	Schwein	Schimpfwort	Y
Sambagott	Gott	Experte	Y
Sängerikone	Ikone	Verkörperung	Y
Sängerpapst	Papst	Autorität	Y
Satuguru	Guru	UNV	N
Säulenapostel	Apostel	Religion	N
Schachkönig	König	Spiel	N
Schäferschwein	Schwein	Tier	N
Schaftbolzen	Bolzen	Stift	N
Schakalgott	Gott	Religion	N
Schälhengst	Hengst	Tier	N
Scharnierbolzen	Bolzen	Stift	N
Schattenbolzen	Bolzen	Projektil	N
Schattengott	Gott	Religion	N
Schattenkönig	König	Monarch	N
Schauspielerikone	Ikone	Verkörperung	Y
Schauspielguru	Guru	Experte	Y
Schauspielikone	Ikone	Verkörperung	Y
Scheckhengst	Hengst	Tier	N
Scheingott	Gott	Religion	N
Scherbolzen	Bolzen	Stift	N
Schiebebolzen	Bolzen	Stift	N
Schiedsrichterschwein	Schwein	Schimpfwort	Y
Schießbolzen	Bolzen	Projektil	N
Schimmelhengst	Hengst	Tier	N
Schinkengott	Gott	Experte	Y
Schismapapst	Papst	Kirche	N
Schlafdreck	Dreck	Schmutz	N
Schlagbolzen	Bolzen	Stift	N
Schlagerapostel	Apostel	Befürworter	Y
Schlagfertigkeitspapst	Papst	Autorität	Y
Schlammschwein	Schwein	Tier	N
Schlangenkönig	König	Monarch	N
Schleimbolzen	Bolzen	hohesMaß	N
Schlichtheitsapostel	Apostel	Befürworter	Y
Schließbolzen	Bolzen	Stift	N
Schließringbolzen	Bolzen	Stift	N
Schlitzhengst	Hengst	Mann	Y
Schmachtbolzen	Bolzen	hohesMaß	N
Schmierdreck	Dreck	Schmutz	N
Schmökerschwein	Schwein	Tier	N
Schmugglerkönig	König	Wichtigkeit	Y
Schneckenhengst	Hengst	Tier	N
Schneckenpapst	Papst	Autorität	Y
Schneedreck	Dreck	Schmutz	N
Schneekönig	König	Monarch	N
Schnullerschwein	Schwein	Tier	N
Schokoladenschweine	Schwein	Tier	N
Schönheitsapostel	Apostel	Befürworter	Y
Schönheitsikone	Ikone	Verkörperung	Y
Schönheitspapst	Papst	Autorität	Y
Schönhengst	Hengst	Tier	N
Schöpfergott	Gott	Religion	N
Schraubbolzen	Bolzen	Stift	N
Schraubenbolzen	Bolzen	Stift	N
Schraubendreck	Dreck	Schmutz	N
Schreckenskönig	König	Monarch	N
Schreibergott	Gott	Experte	Y
Schreibguru	Guru	Experte	Y
Schreibstubenhengst	Hengst	Mann	Y
Schreibtischhengst	Hengst	Mann	Y
Schreissdreck	Dreck	niedrigeQualität	Y
Schriftgott	Gott	Religion	N
Schriftikone	Ikone	Verkörperung	Y
Schrottgott	Gott	Religion	N
Schuldapostel	Apostel	Befürworter	Y
Schuldenkönig	König	Wichtigkeit	Y
Schulhengst	Hengst	Mann	Y
Schulikone	Ikone	Verkörperung	Y
Schussbolzen	Bolzen	Projektil	N
Schußbolzen	Bolzen	Projektil	N
Schützengrabendreck	Dreck	Schmutz	N
Schützenkönig	König	Wichtigkeit	Y
Schwalbengott	Gott	Experte	Y
Schwalbenkönig	König	Monarch	N
Schwammerlguru	Guru	Experte	Y
Schwanenkönig	König	Monarch	N
Schwedenhengst	Hengst	Tier	N
Schwedenkönig	König	Monarch	N
Schweinedreck	Dreck	Kot	N
Schweißhengst	Hengst	Tier	N
Schweizerapostel	Apostel	Religion	N
Schweizerikone	Ikone	Verkörperung	Y
Schwertbolzen	Bolzen	Stift	N
Schwingenlagerbolzen	Bolzen	Stift	N
Schwulenikone	Ikone	Verkörperung	Y
Seelenguru	Guru	Religion	N
Seelsorgepapst	Papst	Kirche	N
Segelikone	Ikone	Verkörperung	Y
Sehergott	Gott	Religion	N
Seifengott	Gott	Religion	N
Seitenbolzen	Bolzen	Stift	N
Sektenapostel	Apostel	Religion	N
Sektengott	Gott	Religion	N
Sektenguru	Guru	Religion	N
Selbsthilfeguru	Guru	Experte	Y
Selbstjustizikone	Ikone	Verkörperung	Y
Septemberpapst	Papst	Autorität	Y
Seriendreck	Dreck	niedrigeQualität	Y
Serienikone	Ikone	Verkörperung	Y
Setzbolzen	Bolzen	Stift	N
Seucheschweinen	Schwein	Tier	N
Sexualpapst	Papst	Autorität	Y
Shetlandponyhengst	Hengst	Tier	N
Shettyjährlingshengst	Hengst	Tier	N
Showhengst	Hengst	Tier	N
Sicherheitsapostel	Apostel	Befürworter	Y
Sicherheitsbolzen	Bolzen	Stift	N
Sicherheitspapst	Papst	Autorität	Y
Sicherungsbolzen	Bolzen	Stift	N
Siegerhengst	Hengst	Tier	N
Sikhguru	Guru	Religion	N
Silberhengst	Hengst	Tier	N
Sitcomikone	Ikone	Verkörperung	Y
Sittenapostel	Apostel	Befürworter	Y
Sittlichkeitsapostel	Apostel	Befürworter	Y
Sitzgurtbolzen	Bolzen	Stift	N
Skandalikone	Ikone	Verkörperung	Y
Skaterikone	Ikone	Verkörperung	Y
Skilaufikone	Ikone	Verkörperung	Y
Slawenapostel	Apostel	Religion	N
Smartmarkguru	Guru	Experte	Y
Softiegott	Gott	Religion	N
Softwaredreck	Dreck	niedrigeQualität	Y
Softwarepapst	Papst	Autorität	Y
Sohnesgott	Gott	Religion	N
Solarenergiepapst	Papst	Autorität	Y
Solarpapst	Papst	Autorität	Y
Soldatenkönig	König	Monarch	N
Soldatenschwein	Schwein	Schimpfwort	Y
Söldnerschweinen	Schwein	Schimpfwort	Y
Sommergott	Gott	Religion	N
Sondergott	Gott	Religion	N
Songwriterikone	Ikone	Verkörperung	Y
Sonnenfinsternispapst	Papst	Kirche	N
Sonnenkönig	König	Monarch	N
Sonnenpapst	Papst	Autorität	Y
Soundguru	Guru	Experte	Y
Sozialapostel	Apostel	Befürworter	Y
Sozialdreck	Dreck	niedrigeQualität	Y
Sozialpapst	Papst	Kirche	N
Sozialstaatsapostel	Apostel	Befürworter	Y
Sozipapst	Papst	Kirche	N
Spannbolzen	Bolzen	Stift	N
Sparapostel	Apostel	Befürworter	Y
Sparschweines	Schwein	Tier	N
Spartanerkönig	König	Monarch	N
Spatzendreck	Dreck	Kot	N
Spatzenpapst	Papst	Autorität	Y
Sperrbolzen	Bolzen	Stift	N
Sperrmüllkönig	König	Wichtigkeit	Y
Spieleguru	Guru	Experte	Y
Spieleikone	Ikone	Verkörperung	Y
Spielerikone	Ikone	Verkörperung	Y
Spielgott	Gott	Religion	N
Spielschwein	Schwein	Glück	N
Spielzeitikone	Ikone	Verkörperung	Y
Spießerschweine	Schwein	Schimpfwort	Y
Spitzenhengst	Hengst	Tier	N
Splatterfilmguru	Guru	Experte	Y
Splattergott	Gott	Experte	Y
Splatterguru	Guru	Experte	Y
Splatterpapst	Papst	Autorität	Y
Sportapostel	Apostel	Befürworter	Y
Sportguru	Guru	Experte	Y
Sporthengst	Hengst	Tier	N
Sportikone	Ikone	Verkörperung	Y
Sportlerhengst	Hengst	Mann	Y
Sportpapst	Papst	Autorität	Y
Sportschwein	Schwein	Schimpfwort	Y
Sprachdreck	Dreck	niedrigeQualität	Y
Sprachikone	Ikone	Verkörperung	Y
Sprachpapst	Papst	Autorität	Y
Spreizbolzen	Bolzen	Stift	N
Sprengbolzen	Bolzen	Projektil	N
Sprengikone	Ikone	Verkörperung	Y
Springhengst	Hengst	Tier	N
Springschweine	Schwein	Tier	N
Sprintkönig	König	Wichtigkeit	Y
Sprühdosenwandbildgott	Gott	UNV	N
Staatsikone	Ikone	Verkörperung	Y
Stabilitätsapostel	Apostel	Befürworter	Y
Stadtikone	Ikone	Verkörperung	Y
Stadtteilikone	Ikone	Verkörperung	Y
Staffageschweine	Schwein	Schimpfwort	Y
Stahlbolzen	Bolzen	Stift	N
Stalldreck	Dreck	Schmutz	N
Stammapostel	Apostel	Religion	N
Stammbolzen	Bolzen	Stift	N
Stammesgott	Gott	Religion	N
Standortdreck	Dreck	niedrigeQualität	Y
Starapostel	Apostel	Befürworter	Y
Starikone	Ikone	Verkörperung	Y
Startdreck	Dreck	UNV	N
Stasischwein	Schwein	Schimpfwort	Y
Statistikapostel	Apostel	Befürworter	Y
Statistikguru	Guru	Experte	Y
Stauferkönig	König	Monarch	N
Steckbolzen	Bolzen	Stift	N
Stehbolzen	Bolzen	Stift	N
Steinapostel	Apostel	Religion	N
Stempelhengst	Hengst	Mann	Y
Steppenhengst	Hengst	Tier	N
Steppenzebrahengst	Hengst	Tier	N
Sternenguru	Guru	Experte	Y
Sternenkönig	König	Monarch	N
Sterngott	Gott	Religion	N
Steuermoralapostel	Apostel	Befürworter	Y
Steuerpapst	Papst	Autorität	Y
Stiergott	Gott	Religion	N
Stilikone	Ikone	Verkörperung	Y
Stimmenkönig	König	Wichtigkeit	Y
Stimmungsdreck	Dreck	niedrigeQualität	Y
Stinktierdreck	Dreck	Kot	N
Stinthengst	Hengst	Fehlt	N
Strahlendreck	Dreck	Schmutz	N
Strahlenpapst	Papst	Autorität	Y
Straßenbahnpapst	Papst	Autorität	Y
Straßenhengst	Hengst	Mann	Y
Strategieguru	Guru	Experte	Y
Streetartikone	Ikone	Verkörperung	Y
streetballgott	Gott	Experte	Y
Streithengst	Hengst	Mann	Y
Stromgott	Gott	Religion	N
Stummfilmikone	Ikone	Verkörperung	Y
Sturmgott	Gott	Religion	N
Sturmkönig	König	Monarch	N
Substanzapostel	Apostel	Befürworter	Y
Suchtbolzen	Bolzen	hohesMaß	N
Sumpfschwein	Schwein	Tier	N
Sündendreck	Dreck	niedrigeQualität	Y
Superdreck	Dreck	Schmutz	N
Superguru	Guru	Experte	Y
Superhengst	Hengst	Tier	N
Superpromihengst	Hengst	Mann	Y
Superschwein	Schwein	Tier	N
Surferikone	Ikone	Verkörperung	Y
Sylvesterhengst	Hengst	Mann	Y
Symandreck	Dreck	UNV	N
Sympathiebolzen	Bolzen	hohesMaß	N
Synchronisationsikone	Ikone	Verkörperung	Y
Synthiegott	Gott	Experte	Y
Systemguru	Guru	Experte	Y
Szeneikone	Ikone	Verkörperung	Y
Taktikguru	Guru	Experte	Y
Tankerkönig	König	Wichtigkeit	Y
Tanztheaterikone	Ikone	Verkörperung	Y
Tastenguru	Guru	Experte	Y
Tastenhengst	Hengst	Mann	Y
Taubendreck	Dreck	Kot	N
Tauchsportikone	Ikone	Verkörperung	Y
Taufgott	Gott	Religion	N
Technikapostel	Apostel	Befürworter	Y
Technikguru	Guru	Experte	Y
Technikikone	Ikone	Verkörperung	Y
Tempeldreck	Dreck	Schmutz	N
Tempelgott	Gott	Religion	N
Temperamentsbolzen	Bolzen	hohesMaß	N
Tempobolzen	Bolzen	hohesMaß	N
Tendaguru	Guru	UNV	N
Tennisguru	Guru	Experte	Y
Tennisikone	Ikone	Verkörperung	Y
Terragigaguru	Guru	Experte	N
Terrorguru	Guru	Experte	Y
Testosteronbolzen	Bolzen	hohesMaß	N
Teufelsbolzen	Bolzen	hohesMaß	N
Teufelsdreck	Dreck	niedrigeQualität	Y
Teufelshengst	Hengst	Tier	N
Teutonenschweine	Schwein	Schimpfwort	Y
Textilguru	Guru	Experte	Y
Textilikone	Ikone	Verkörperung	Y
Theaterguru	Guru	Experte	Y
Theaterikone	Ikone	Verkörperung	Y
Theorieguru	Guru	Experte	Y
Therapieguru	Guru	Experte	Y
Tierrechtsapostel	Apostel	Befürworter	Y
Tierschutzguru	Guru	Experte	Y
Tigergott	Gott	Religion	N
Tigerscheckhengst	Hengst	Tier	N
Tinkerhengst	Hengst	Tier	N
Titularkönig	König	Monarch	N
Toleranzapostel	Apostel	Befürworter	Y
Torfschwein	Schwein	Tier	N
Torschützenkönig	König	Wichtigkeit	Y
Torwartgott	Gott	Experte	Y
Torwartikone	Ikone	Verkörperung	Y
Tourismusguru	Guru	Experte	Y
Touristenikone	Ikone	Verkörperung	Y
Trainerguru	Guru	Experte	Y
Trainerikone	Ikone	Verkörperung	Y
Trakehnerhengst	Hengst	Tier	N
Trampeltierhengst	Hengst	Tier	N
Transportbolzen	Bolzen	Stift	N
Transsexuellenikone	Ikone	Verkörperung	Y
Traufgott	Gott	Religion	N
Traugott	Gott	UNV	N
Traumhengst	Hengst	Tier	N
Traumkönig	König	Monarch	N
Treckerdreck	Dreck	Schmutz	N
Trendguru	Guru	Experte	Y
Trennbolzen	Bolzen	Stift	N
Tresorbolzen	Bolzen	Stift	N
Trickfilmikone	Ikone	Verkörperung	Y
Tricksergott	Gott	Religion	N
Trolldreck	Dreck	Schmutz	N
Trollkönig	König	Monarch	N
Trommelgott	Gott	Experte	Y
Trommelguru	Guru	Experte	Y
Trompetenguru	Guru	Experte	Y
Trompetenschwein	Schwein	Tier	N
Trüffelguru	Guru	Experte	Y
Trüffelschweinen	Schwein	Tier	N
Trümmerdreck	Dreck	Schmutz	N
Tugendapostel	Apostel	Befürworter	Y
Turbohengst	Hengst	Mann	Y
Türbolzen	Bolzen	Stift	N
Turboschweinen	Schwein	Tier	N
Türkendreck	Dreck	niedrigeQualität	Y
Türkenkönig	König	Monarch	N
Türkenschwein	Schwein	Schimpfwort	Y
Turnierhengst	Hengst	Tier	N
Twitterdreck	Dreck	niedrigeQualität	Y
Überguru	Guru	Experte	Y
Überübergott	Gott	Religion	N
Uhrenikone	Ikone	Verkörperung	Y
Umweltapostel	Apostel	Befürworter	Y
Umweltdreck	Dreck	Schmutz	N
Unabhängigkeitsapostel	Apostel	Befürworter	Y
Undergroundguru	Guru	Experte	Y
Ungarnkönig	König	Monarch	N
Ungarschwein	Schwein	Schimpfwort	Y
Unionskönig	König	Monarch	N
Unterdrückerschwein	Schwein	Schimpfwort	Y
Untergangsapostel	Apostel	Befürworter	Y
Untergott	Gott	Religion	N
Unterhaltungsdreck	Dreck	niedrigeQualität	Y
Unterhaltungsikone	Ikone	Verkörperung	Y
Unterkönig	König	Monarch	N
Unterweltkönig	König	Wichtigkeit	Y
Urschöpfergott	Gott	Religion	N
Urschuhapostel	Apostel	Befürworter	Y
Urwaldgott	Gott	Experte	Y
Vandalenkönig	König	Monarch	N
Vätergott	Gott	Religion	N
Vaterhengst	Hengst	Tier	N
Vaterschweine	Schwein	Tier	N
Verankerungsbolzen	Bolzen	Stift	N
Veranstaltungsguru	Guru	Experte	Y
Verbalikone	Ikone	Verkörperung	Y
Verbandshengst	Hengst	Mann	Y
Verbindungsbolzen	Bolzen	Stift	N
Verbotsapostel	Apostel	Befürworter	Y
Verbrecherkönig	König	Wichtigkeit	Y
Verdummungsapostel	Apostel	Befürworter	Y
Vereinsdreck	Dreck	niedrigeQualität	Y
Verkehrsgott	Gott	Religion	N
Verkehrsguru	Guru	Experte	Y
Verklärungsikone	Ikone	Religion	N
Verlustschwein	Schwein	Schimpfwort	Y
Vernunftapostel	Apostel	Befürworter	Y
Verriegelungsbolzen	Bolzen	Stift	N
Verschlussbolzen	Bolzen	Stift	N
Verschlußbolzen	Bolzen	Stift	N
Verschraubungsbolzen	Bolzen	Stift	N
Versöhnergott	Gott	Religion	N
Versöhnungsapostel	Apostel	Befürworter	Y
Versuchsschweinen	Schwein	Tier	N
Vertäuensbolzen	Bolzen	Stift	N
Verwaltungshengst	Hengst	Mann	Y
Verzichtsapostel	Apostel	Befürworter	Y
Verzückungsgott	Gott	Experte	Y
Vicekönig	König	Monarch	N
Videospielikone	Ikone	Verkörperung	Y
Vierkantbolzen	Bolzen	Stift	N
vinylguru	Guru	Experte	Y
Virginitätsapostel	Apostel	Befürworter	Y
Visionsapostel	Apostel	Befürworter	Y
Vitalitätsbolzen	Bolzen	hohesMaß	N
Vitaminapostel	Apostel	Befürworter	Y
Vitaminguru	Guru	Experte	Y
Vizeguru	Guru	Religion	N
Vizekönig	König	Monarch	N
Vogelkönig	König	Wichtigkeit	Y
Völkerapostel	Apostel	Religion	N
Volksdreck	Dreck	niedrigeQualität	Y
Volkskönig	König	Monarch	N
Volkswirtschaftsapostel	Apostel	Befürworter	Y
Vollblutaraberhengst	Hengst	Tier	N
Vollbluthengst	Hengst	Tier	N
Vollschweinen	Schwein	Tier	N
Voltigierhengst	Hengst	Tier	N
Vorschriftenhengst	Hengst	Mann	Y
Vorstandsschweine	Schwein	Schimpfwort	Y
Wachstumsapostel	Apostel	Befürworter	Y
Wachtelkönig	König	Fehlt	N
Wackeldreck	Dreck	niedrigeQualität	Y
Wahlkönig	König	Wichtigkeit	Y
Wahlrechtsguru	Guru	Experte	Y
Wahrheitsapostel	Apostel	Befürworter	Y
Walddreck	Dreck	Schmutz	N
Waldesgott	Gott	Religion	N
Waldkönig	König	Monarch	N
Waldorfguru	Guru	Experte	Y
Walzerkönig	König	Wichtigkeit	Y
Wanderapostel	Apostel	Religion	N
Wanderguru	Guru	Experte	Y
Wandlitzschwein	Schwein	Schimpfwort	Y
Wappenkönig	König	Monarch	N
Warmbluthengst	Hengst	Tier	N
Warzenschwein	Schwein	Tier	N
Wassergott	Gott	Religion	N
Wasserguru	Guru	Experte	Y
Waßkönig	König	Fehlt	N
Waveikone	Ikone	Verkörperung	Y
Wechselwirkungsgott	Gott	Fehlt	N
Weibergott	Gott	Religion	N
Weiberhengst	Hengst	Mann	Y
Weidehengst	Hengst	Tier	N
Weiheikone	Ikone	Religion	N
Weihnachtsgott	Gott	Religion	N
Weihnachtsikone	Ikone	Religion	N
Weingott	Gott	Religion	N
Weinguru	Guru	Experte	Y
Weinhengst	Hengst	Fehlt	N
Weisheitsgott	Gott	Religion	N
Weißweinguru	Guru	Experte	Y
Wellnessapostel	Apostel	Befürworter	Y
Welsh-Ponyhengst	Hengst	Tier	N
Weltmusikikone	Ikone	Verkörperung	Y
Weltraumdreck	Dreck	Schmutz	N
Weltuntergangsapostel	Apostel	Befürworter	Y
Weltuntergangsguru	Guru	Religion	N
Werbeguru	Guru	Experte	Y
Werbekönig	König	Wichtigkeit	Y
Werkzeugikone	Ikone	Verkörperung	Y
Westgotenkönig	Gott	Monarch	N
Westküstenikone	Ikone	Verkörperung	Y
Westschweine	Schwein	Schimpfwort	Y
Wettbewerbsapostel	Apostel	Befürworter	Y
Wetterapostel	Apostel	Befürworter	Y
Wettergott	Gott	Religion	N
Wetterguru	Guru	Experte	Y
Wettkönig	König	Wichtigkeit	Y
Widerstandsikone	Ikone	Verkörperung	Y
Wikingergott	Gott	Religion	N
Wikingerkönig	König	Monarch	N
Wildhengst	Hengst	Tier	N
Wildpferdhengst	Hengst	Tier	N
Wildschwein	Schwein	Tier	N
Winterdreck	Dreck	Schmutz	N
Winterkönig	König	Monarch	N
Wirtschaftsguru	Guru	Experte	Y
Wirtschaftsikone	Ikone	Verkörperung	Y
Wissensguru	Guru	Experte	Y
Witzbolzen	Bolzen	hohesMaß	N
Wohnungsschweine	Schwein	Schimpfwort	Y
Wollmilchschweine	Schwein	Tier	N
Wollschweins	Schwein	Tier	N
Wordspielschwein	Schwein	Fehlt	N
Wortdreck	Dreck	niedrigeQualität	Y
Wrestlingikone	Ikone	Verkörperung	Y
Wunderapostel	Apostel	Befürworter	Y
Wundergott	Gott	Religion	N
Wunderhengst	Hengst	Tier	N
Wunderschwein	Schwein	Tier	N
Wurzelguru	Guru	Experte	Y
Wüstendreck	Dreck	Schmutz	N
Wüstenikone	Ikone	Verkörperung	Y
Yorkshire-Schwein	Schwein	Tier	N
Yuppidreck	Dreck	niedrigeQualität	Y
Zapfenschwein	Schwein	Tier	N
Zarenikone	Ikone	Religion	N
Zauberkönig	König	Monarch	N
Zaunkönig	König	Fehlt	N
Zebrahengst	Hengst	Tier	N
Zeckendreck	Dreck	niedrigeQualität	Y
Zeckenschwein	Schwein	Schimpfwort	Y
Zeigefingergott	Gott	Religion	N
Zeitgeistapostel	Apostel	Befürworter	Y
Zeitikone	Ikone	Verkörperung	Y
Zentralikone	Ikone	Religion	N
zickengott	Gott	Religion	N
Ziegengott	Gott	Religion	N
Ziegenschweinen	Schwein	Tier	N
Zirkusdreck	Dreck	Schmutz	N
Zirkusschwein	Schwein	Tier	N
Zivilisationsdreck	Dreck	niedrigeQualität	Y
Züchterschweine	Schwein	Tier	N
Zuchthengst	Hengst	Tier	N
Zukunftsapostel	Apostel	Befürworter	Y
Zukunftshengst	Hengst	Tier	N
Zündbolzen	Bolzen	Stift	N
Zweitgott	Gott	Religion	N
Zwergenkönig	König	Monarch	N
Zwergenschwein	Schwein	Tier	N
