Abfalldreck	Abfall|Dreck
Abfuehrgott	abführen|Gott
Abführgott	abführen|Gott
Abgasdreck	Abgas|Dreck
Abgeordnetenschweine	Abgeordneter|Schwein
Abmahndreck	abmahnen|Dreck
Abrüstungsapostel	Abrüstung|Apostel
Abschaffungsapostel	Abschaffung|Apostel
Abstiegsdreck	Abstieg|Dreck
Abwaschdreck	Abwasch|Dreck
Abwasserdreck	Abwasser|Dreck
Abwehrikone	Abwehr|Ikone
Achsbolzen	Achse|Bolzen
Achsschenkelbolzen	Achsschenkel|Bolzen
Ackerdreck	Acker|Dreck
Adlerkönig	Adler|König
Admingott	Admin|Gott
Affendreck	Affe|Dreck
Affenkönig	Affe|König
Afrikaapostel	Afrika|Apostel
Afterapostel	After|Apostel
Ägypterkönig	Ägypter|König
Aktienguru	Aktie|Guru
Alleingott	allein|Gott
Allerheiligenikone	Allerheiligen|Ikone
Allmachtsgott	Allmacht|Gott
Alltagsdreck	Alltag|Dreck
Alltagsikone	Alltag|Ikone
Alpakahengst	Alpaka|Hengst
Alpendreck	Alpen|Dreck
Alpenikone	Alpen|Ikone
Alpenkönig	Alpen|König
Alptraumikone	Alptraum|Ikone
Altschneedreck	Altschnee|Dreck
Aluminiumbolzen	Aluminium|Bolzen
Ameisenkönig	Ameise|König
Ampelgott	Ampel|Gott
Amtshengst	Amt|Hengst
Anabolikahengst	Anabolikum|Hengst
Anarchapostel	Anarchie|Apostel
Andalusierhengst	Andalusier|Hengst
Angelguru	Angel|Guru
Angriffsapostel	Angriff|Apostel
Angstbolzen	Angst|Bolzen
Angsthasenapostel	Angsthase|Apostel
Anhangsdreck	Anhang|Dreck
Animierschwein	animieren|Schwein
Ankerbolzen	Anker|Bolzen
Anleihenguru	Anleihe|Guru
Anpassungsapostel	Anpassung|Apostel
Anschlagbolzen	Anschlag|Bolzen
Anschlussbolzen	Anschluss|Bolzen
Anstandspapst	Anstand|Papst
Antibiotikaschweine	Antibiotikum|Schwein
anti-gott	anti|Gott
Antiguru	anti|Guru
Antiimperialistendreck	Antiimperialist|Dreck
Antimoralapostel	Antimoral|Apostel
Antoniusschweine	Antonius|Schwein
Anzughengst	Anzug|Hengst
Apfelguru	Apfel|Guru
Appaloosahengst	Appaloosa|Hengst
Aquapapst	Aqua|Papst
Araberhengst	Araber|Hengst
Arbeiterapostel	Arbeiter|Apostel
Arbeiterpapst	Arbeiter|Papst
Arbeiterschwein	Arbeiter|Schwein
Arbeitshengst	Arbeit|Hengst
Arbeitsikone	Arbeit|Ikone
Arbeitsmarktguru	Arbeitsmarkt|Guru
Architektenikone	Architekt|Ikone
Architekturikone	Architektur|Ikone
Architekturpapst	Architektur|Papst
Armbrustbolzen	Armbrust|Bolzen
Asbestpapst	Asbest|Papst
Aschendreck	Asche|Dreck
Assyrerkönig	Assyrer|König
Astralgott	astral|Gott
Asylantenschwein	Asylant|Schwein
Atommülldreck	Atommüll|Dreck
Atompapst	Atom|Papst
Aufhängebolzen	aufhängen|Bolzen
Aufklärungsapostel	Aufklärung|Apostel
Aufklärungsikone	Aufklärung|Ikone
Aufklärungspapst	Aufklärung|Papst
Aufruhrgott	Aufruhr|Gott
Aufstiegsgott	Aufstieg|Gott
Augendreck	Auge|Dreck
Augustbolzen	August|Bolzen
Ausbrecherkönig	Ausbrecher|König
Ausländerdreck	Ausländer|Dreck
Ausländerschweinen	Ausländer|Schwein
Ausnahmehengst	Ausnahme|Hengst
Ausreißerkönig	Ausreißer|König
Ausreißerschwein	Ausreißer|Schwein
Außenseiterpapst	Außenseiter|Papst
Auswurfbolzen	Auswurf|Bolzen
Authentizitätsapostel	Authentizität|Apostel
Autogott	Auto|Gott
autoguru	Auto|Guru
Autokönig	Auto|König
Automobilikone	Automobil|Ikone
Autopapst	Auto|Papst
Autorengott	Autor|Gott
Babyschwein	Baby|Schwein
Bachpapst	Bach|Papst
Bäderkönig	Bad|König
Bahnsportikone	Bahnsport|Ikone
Ballenbolzen	Ballen|Bolzen
Balsamiergott	balsamieren|Gott
Bambuspapst	Bambus|Papst
Bänksterdreck	Bänkster|Dreck
Barberinipapst	Barberini|Papst
Barfußguru	barfuß|Guru
Barnevelderpapst	Barnvelder|Papst
Barrashengst	Barrass|Hengst
Basiliskenkönig	Basilisk|König
Basketballikone	Basketball|Ikone
Baumgott	Baum|Gott
Baumpapst	Baum|Papst
Baustellendreck	Baustelle|Dreck
Bayernapostel	Bayern|Apostel
Bayernkönig	Bayern|König
Beas-Satguru	Beas-Sat|Guru
Befestigungsbolzen	Befestigung|Bolzen
Beflissenheitsapostel	Beflissenheit|Apostel
Befruchtungsguru	Befruchtung|Guru
Befruchtungspapst	Befruchtung|Papst
Begründerhengst	Begründer|Hengst
Behindertenschweine	Behinderter|Schwein
Behördenhengst	Behörde|Hengst
Beihilfepapst	Beihilfe|Papst
Benimmpapst	Benimm|Papst
Benzinschwein	Benzin|Schwein
Beraterpapst	Berater|Papst
Berberhengst	Berber|Hengst
Bergikone	Berg|Ikone
Bergkönig	Berg|König
Bergschweinen	Berg|Schwein
Berufshengst	Beruf|Hengst
Beschwichtigungsapostel	Beschwichtigung|Apostel
Betriebswirtschaftsguru	Betriebswirtschaft|Guru
Betroffenheitsapostel	Betroffenheit|Apostel
Bettlerkönig	Bettler|König
Bewegungsguru	Bewegung|Guru
Bewegungsikone	Bewegung|Ikone
Beziehungsguru	Beziehung|Guru
Bezirksapostel	Bezirk|Apostel
Bhaisajyaguru	Bhaisajya|Guru
Bhaishavaguru	Bhaishava|Guru
Biergartenguru	Biergarten|Guru
Bierguru	Bier|Guru
Bierkönig	Bier|König
Bierpapst	Bier|Papst
Bilanzenpapst	Bilanz|Papst
Bildikone	Bild|Ikone
Bildschirmpapst	Bildschirm|Papst
Bildungsapostel	Bildung|Apostel
Bildungsikone	Bildung|Ikone
Bildungspapst	Bildung|Papst
Blasmusikpapst	Blasmusik|Papst
Bleibolzen	Blei|Bolzen
Blitzbolzen	Blitz|Bolzen
Blödsinnsapostel	Blödsinn|Apostel
Bluesrockikone	BluesRock|Ikone
Blutmischungsapostel	Blutmischung|Apostel
Bocksgott	Bock|Gott
Boersenguru	Börse|Guru
Bogenpapst	Bogen|Papst
Böhmenkönig	Böhmen|König
Bohnenkönig	Bohne|König
Borghesepapst	Borghese|Papst
Borgiapapst	Borgia|Papst
Borlandschwein	Borland|Schwein
Börsenguru	Börse|Guru
Börsenschweine	Börse|Schwein
Borstenschwein	Borste|Schwein
Botengott	Bote|Gott
Boulevarddreck	Boulevard|Dreck
Bourbonenkönig	Bourbone|König
Braunkohlendreck	Braunkohle|Dreck
Brechbolzen	brechen|Bolzen
Bremsbolzen	bremsen|Bolzen
Brillenapostel	Brille|Apostel
Britenkönig	Brite|König
Bronzebolzen	Bronze|Bolzen
Bronzeschwein	Bronze|Schwein
Browserdreck	Browser|Dreck
Brückenpapst	Brücke|Papst
Brucknerguru	Bruckern|Guru
Bücherpapst	Buch|Papst
Buchguru	Buch|Guru
Buchschwein	Buch|Schwein
Buddlerguru	Buddler|Guru
Buddyikone	Buddy|Ikone
Bügelbolzen	Bügel|Bolzen
Bühnendreck	Bühne|Dreck
Bühnengott	Bühne|Gott
Bühnenguru	Bühne|Guru
Bühnenhengst	Bühne|Hengst
Bundesgott	Bund|Gott
Bundessiegerhengst	Bundessieger|Hengst
Bürgerkönig	Bürger|König
Bürgerrechtsikone	Bürgerrecht|Ikone
Bürgerschwein	Bürger|Schwein
Burgunderkönig	Burgunder|König
Bürohengst	Büro|Hengst
Bürokratenhengst	Bürokrat|Hengst
Bürokratenschwein	Bürokrat|Schwein
Buschschweines	Busch|Schwein
Busenikone	Busen|Ikone
Businessguru	Business|Guru
Butterschwein	Butter|Schwein
Camarguehengst	Camargue|Hengst
Cashguru	Cash|Guru
Cembalopapst	Cembalo|Papst
Championhengst	Champion|Hengst
Chancengerechtigkeitsapostel	Chancengerechtigkeit|Apostel
Charakterbolzen	Charakter|Bolzen
Charakterschweinen	Charakter|Schwein
Charmebolzen	Charme|Bolzen
Chauvinistenhengst	Chauvinist|Hengst
Chauvischweine	Chauvi|Schwein
Chefapostel	Chef|Apostel
Chefguru	Chef|Guru
Chefschwein	Chef|Schwein
Chemiedreck	Chemie|Dreck
Chemieschweine	Chemie|Schwein
Chietlerjungenschwein	Hitlerjunge|Schwein
christengott	Christ|Gott
Christenpapst	Christ|Papst
Christenschwein	Christ|Schwein
Christgott	Christ|Gott
Christusikone	Christus|Ikone
Cocktailpapst	Cocktail|Papst
Comicguru	Comic|Guru
Comicikone	Comic|Ikone
Comicpapst	Comic|Papst
Computerdreck	Computer|Dreck
Computerguru	Computer|Guru
Computerpapst	Computer|Papst
Contentpapst	Content|Papst
Corradohengst	Corrado|Hengst
Cyberikone	Cyber|Ikone
Dämonendreck	Dämon|Dreck
Dämonengott	Dämon|Gott
Dämonenkönig	Dämon|König
Dänenkönig	Däne|König
Darmdreck	Darm|Dreck
Datenguru	Datum|Guru
Datenmüllpapst	Datenmüll|Papst
Deckhengst	decken|Hengst
Dekadenzbolzen	Dekadenz|Bolzen
Deklamationsapostel	Deklamation|Apostel
Demenzbolzen	Demenz|Bolzen
Deregulierungsapostel	Deregulierung|Apostel
DerMoralapostel	DerMoral|Apostel
Designguru	Design|Guru
Designikone	Design|Ikone
Deutschenapostel	Deutscher|Apostel
Dezemberdreck	Dezember|Dreck
Diätapostel	Diät|Apostel
Diätguru	Diät|Guru
Dichtergott	Dichter|Gott
Dichterikone	Dichter|Ikone
Dichterkönig	Dichter|König
Dichterpapst	Dichter|Papst
Dichtungspapst	Dichtung|Papst
Dieseldreck	Diesel|Dreck
Dieselpapst	Diesel|Papst
Dieselschweine	Diesel|Schwein
Dimetikone	Dimet|Ikone
Diplomatenpapsts	Diplomat|Papst
Discounter-dreck	Discounter|Dreck
Diskohengst	Disko|Hengst
Dohlendreck	Dohle|Dreck
Donaupapst	Donau|Papst
Donnerbolzen	Donner|Bolzen
Donnergott	Donner|Gott
Doofbolzen	doof|Bolzen
Doppelmoralapostel	Doppelmoral|Apostel
Doppeltschwein	doppelt|Schwein
Dorfapostel	Dorf|Apostel
Dorfdreck	Dorf|Dreck
Dorfgott	Dorf|Gott
Dornenkönig	Dorn|König
Dorschkönig	Dorsch|König
Drachendreck	Drache|Dreck
Drachengott	Drache|Gott
Drachenkönig	Drache|König
Drecksschwein	Dreck|Schwein
Drehbolzen	drehen|Bolzen
Drehbuchguru	Drehbuch|Guru
Drehbuchpapst	Drehbuch|Papst
Drehzahlhengst	Drehzahl|Hengst
Dreifaltigkeitsikone	Dreifaltigkeit|Ikone
Dreikönig	drei|König
Drei-Linien-Kreuzungsschwein	Dreilinienkreuzung|Schwein
Dressurhengst	Dressur|Hengst
Dribbelgott	dribbeln|Gott
Dribbelkönig	dribbeln|König
Driftikone	Drift|Ikone
Drogenapostel	Droge|Apostel
Drogendreck	Droge|Dreck
Drogenguru	Droge|Guru
Drogenkönig	Droge|König
Drogenschwein	Droge|Schwein
Drohgott	drohen|Gott
Dromedarhengst	Dromedar|Hengst
Druckbolzen	Druck|Bolzen
Druckschwein	Druck|Schwein
Dschungelkönig	Dschungel|König
Dübelgott	dübeln|Gott
Dulderpapst	Dulder|Papst
Dummbolzen	dumm|Bolzen
Dummheitsapostel	Dummheit|Apostel
Dunkelkammerpapst	Dunkelkammer|Papst
Durchhaltedreck	durchhalten|Dreck
Durchhalteikone	durchhalten|Ikone
Durschnittsdreck	Durschnitt|Dreck
Ebergott	Eber|Gott
Edelstahlbolzen	Edelstahl|Bolzen
Effizienzapostel	Effizienz|Apostel
Ehrenkönig	Ehre|König
Eichelschwein	Eichel|Schwein
Eifersuchtsbolzen	Eifersucht|Bolzen
Einbrecherkönig	Einbrecher|König
Einheitsapostel	Einheit|Apostel
Einheitsdreck	Einheit|Dreck
Einheitsgott	Einheit|Gott
Einhornhengst	Einhorn|Hengst
Einrastbolzen	einrasten|Bolzen
Einsamkeitsapostel	Einsamkeit|Apostel
Einwanderungsapostel	Einwanderung|Apostel
Eisenbahnkönig	Eisenbahn|König
Eisenbolzen	Eisen|Bolzen
Eisenschweine	Eisen|Schwein
Eisenstahlbolzen	Eisenstahl|Bolzen
Eitelkeitsikone	Eitelkeit|Ikone
Ekelbolzen	Ekel|Bolzen
Elbenkönig	Elb|König
Elbenschweine	Elb|Schwein
Elefantenzuchtpapst	Elefantenzucht|Papst
Elektronikpapst	Elektronik|Papst
Elfenkönig	Elfe|König
Elitehengst	Elite|Hengst
Emotionsbolzen	Emotion|Bolzen
Empfindlichkeits­apostel	Empfindlichkeit|Apostel
Endzeitapostel	Endzeit|Apostel
Endzeitguru	Endzeit|Guru
Endzeit-Sektenguru	Endzeitsekte|Guru
Energiebolzen	Energie|Bolzen
Energieguru	Energie|Guru
Energiepapst	Energie|Papst
Energiesparschwein	Energiesparen|Schwein
Engelpapst	Engel|Papst
Engelspapst	Engel|Papst
Engelspapsts	Engel|Papst
Entertainmentikone	Entertainment|Ikone
Enthüllungsguru	Enthüllung|Guru
Entschleunigungsapostel	Entschleunigung|Apostel
Entwicklerikone	Entwickler|Ikone
Entwicklungsdreck	Entwicklung|Dreck
Erbgesundheitsapostel	Erbgesundheit|Apostel
Erbsenschwein	Erbse|Schwein
Erdbeerikone	Erdbeere|Ikone
Erfolgshengst	Erfolg|Hengst
Erklärungsikone	Erklärung|Ikone
Erlenkönig	Erle|König
Erlösergott	Erlöser|Gott
Ernährungsapostel	Ernährung|Apostel
Ernährungsguru	Ernährung|Guru
Ernährungspapst	Ernährung|Papst
Erotikikone	Erotik|Ikone
Erotikpapst	Erotik|Papst
Ersatzapostel	Ersatz|Apostel
Ersatzbolzen	Ersatz|Bolzen
Ersatzhengst	Ersatz|Hengst
Ersatzikone	Ersatz|Ikone
Ersatzkönig	Ersatz|König
Erstapostel	erster|Apostel
Erziehungsdreck	Erziehung|Dreck
Erziehungsguru	Erziehung|Guru
Erziehungspapst	Erziehung|Papst
Eselhengst	Esel|Hengst
Eselsgott	Esel|Gott
Esoterikguru	Esoterik|Guru
Etappenhengst	Etappe|Hengst
Ethikapostel	Ethik|Apostel
Eventpapst	Event|Papst
Ewenkengott	Ewenke|Gott
Ewigkeitsgott	Ewigkeit|Gott
Exodusgott	Exodus|Gott
Explosivbolzen	explosiv|Bolzen
Exzenterbolzen	Exzenter|Bolzen
Facebook-dreck	Facebook|Dreck
Fahrradlenkerbolzen	Fahrradlenker|Bolzen
Falkengott	Falke|Gott
Familiendreck	Familie|Dreck
Familienikone	Familie|Ikone
Fangbolzen	fangen|Bolzen
Faschodreck	Fascho|Dreck
Faschoschweine	Fascho|Schwein
Fashionikone	Fashion|Ikone
Fastpapst	fast|Papst
Federbolzen	Feder|Bolzen
Federkönig	Feder|König
feel-good-guru	feel-good|Guru
Feenkönig	Fee|König
Fernsehgott	Fernsehen|Gott
Fernsehguru	Fernsehen|Guru
Festikone	Fest|Ikone
Festmachbolzen	festmachen|Bolzen
Fetenguru	Fete|Guru
Feuergott	Feuer|Gott
Feuerkönig	Feuer|König
Fickschweine	ficken|Schwein
Filmgott	Film|Gott
Filmguru	Film|Guru
Filmikone	Film|Ikone
Filmlizenzdreck	Filmlizenz|Dreck
Filmpapst	Film|Papst
Finanzguru	Finanz|Guru
Finanzierungsguru	Finanzierung|Guru
Firmenikone	Firma|Ikone
Fischdreck	Fisch|Dreck
Fischerkönig	Fischer|König
Fischkönig	Fisch|König
Fischpapst	Fisch|Papst
Fitnessapostel	Fitness|Apostel
Fitnessgott	Fitness|Gott
Fitnessguru	Fitness|Guru
Fitnesspapst	Fitness|Papst
Fjordhengst	Fjord|Hengst
Flankengott	Flanke|Gott
Fleischkönig	Fleisch|König
Fleißapostel	Fleiß|Apostel
Flexibilitätsapostel	Flexibilität|Apostel
Fliegendreck	Fliege|Dreck
Fliegengott	Fliege|Gott
Fliegergott	Flieger|Gott
Fliegerinnenikone	Fliegerin|Ikone
Flirtgott	Flirt|Gott
Fluggott	Flug|Gott
Flugzeugikone	Flugzeug|Ikone
Flussdreck	Fluss|Dreck
Flusskönig	Fluss|König
Flußkönig	Fluss|König
Fohlenhengst	Fohlen|Hengst
Folgedreck	Folge|Dreck
Folksongikone	Folksong|Ikone
forengott	Forum|Gott
Fortschrittsapostel	Fortschritt|Apostel
Forumsgott	Forum|Gott
Fotografieikone	Fotografie|Ikone
Frankenapostel	Franke|Apostel
Frankenkönig	Franke|König
Frankenschweins	Franke|Schwein
Franzosenhengst	Franzose|Hengst
Frauenikone	Frau|Ikone
Freihandelsapostel	Freihandel|Apostel
Freihandelspapst	Freihandel|Papst
Freiheitsapostel	Freiheit|Apostel
Freiheitsikone	Freiheit|Ikone
Freistoßgott	Freistoß|Gott
Freizeitpapst	Freizeit|Papst
Fresspapst	fressen|Papst
Freudengott	Freude|Gott
Friedenapostel	Frieden|Apostel
Friedensapostel	Frieden|Apostel
Friedenskönig	Frieden|König
Friedenspapst	Frieden|Papst
Friedhofsgott	Friedhof|Gott
Friesenapostel	Friese|Apostel
Friesenhengst	Friese|Hengst
Friesenpapst	Friese|Papst
Frisurenikone	Frisur|Ikone
Frontikone	Front|Ikone
Froschkönig	Frosch|König
Fructosegott	Fructose|Gott
Frustbolzen	Frust|Bolzen
Fuchsgott	Fuchs|Gott
Fuchshengst	Fuchs|Hengst
Führerschwein	Führer|Schwein
Führungsbolzen	Führung|Bolzen
Fundamentbolzen	Fundament|Bolzen
Furchtikone	Furcht|Ikone
Fußballapostel	Fußball|Apostel
Fußballguru	Fußball|Guru
Fussballikone	Fußball|Ikone
Fußbodendreck	Fußboden|Dreck
Fussekguru	Fussek|Guru
GaLaguru	Gala|Guru
Gameguru	Game|Guru
Gangsterkönig	Gangster|König
Gänsedreck	Gans|Dreck
Gartengott	Garten|Gott
Gastroguru	Gastro|Guru
Gebetsapostel	Gebet|Apostel
Geborgenheitsapostel	Geborgenheit|Apostel
Gebotsgott	Gebot|Gott
Gebührenpapst	Gebühr|Papst
Gedankendreck	Gedanke|Dreck
Gefälligkeitsapostel	Gefälligkeit|Apostel
Gefühlsdreck	Gefühl|Dreck
Gegenikone	gegen|Ikone
Gegenkönig	gegen|König
Gegenkulturikone	Gegenkultur|Ikone
Gegenpapste	gegen|Papst
Gegenpapst	gegen|Papst
Geheimpapst	geheim|Papst
Geissdreck	Geiß|Dreck
Geisterhengst	Geist|Hengst
Geisterkönig	Geist|König
Geistesapostel	Geist|Apostel
Gelddreck	Geld|Dreck
geld-gott	Geld|Gott
Geldgott	Geld|Gott
Geldguru	Geld|Guru
Geldschwein	Geld|Schwein
Gelenkbolzen	Gelenk|Bolzen
Gemütsikone	Gemüt|Ikone
Gemütsschwein	Gemüt|Schwein
Genieapostel	Genie|Apostel
Genmaisdreck	Genmais|Dreck
Genrekönig	Genre|König
Georgsikone	Georg|Ikone
Gerechtigkeitsapostel	Gerechtigkeit|Apostel
Gerichtsdreck	Gericht|Dreck
Germanenapostel	Germane|Apostel
Gesangsikone	Gesang|Ikone
Geschmacksikone	Geschmack|Ikone
Geschmackspapst	Geschmack|Papst
Geschoßbolzen	Geschoss|Bolzen
Gesellschaftshengst	Gesellschaft|Hengst
Gesellschaftsikone	Gesellschaft|Ikone
Gesetzeshengst	Gesetz|Hengst
Gestammeldreck	Gestammel|Dreck
Gestütshengst	Gestüt|Hengst
Gesundheitsapostel	Gesundheit|Apostel
Gesundheitsguru	Gesundheit|Guru
Gesundheitspapst	Gesundheit|Papst
Gesunheitsapostel	Gesundheit|Apostel
Gewaltapostel	Gewalt|Apostel
Gewaltfreiheitsapostel	Gewaltfreiheit|Apostel
Gewerbedreck	Gewerbe|Dreck
Gewindebolzen	Gewinde|Bolzen
Gewißheitsapostel	Gewissheit|Apostel
Gewittergott	Gewitter|Gott
Gewohnheitsdreck	Gewohnheit|Dreck
Giftbolzen	Gift|Bolzen
Giftgasguru	Giftgas|Guru
Gipfelguru	Gipfel|Guru
Giraffenhengst	Giraffe|Hengst
Gitarrendreck	Gitarre|Dreck
Gitarrenguru	Gitarre|Guru
Gitarrenikone	Gitarre|Ikone
Glaspapst	Glas|Papst
Glatteisgott	Glatteis|Gott
Glatzengott	Glatze|Gott
Glaubensapostel	Glaube|Apostel
Glaubenspapst	Glaube|Papst
Glaubwürdigkeitsikone	Glaubwürdigkeit|Ikone
Gleichberechtigungsapostel	Gleichberechtigung|Apostel
Gleichheitsapostel	Gleichheit|Apostel
Gleitlagerpapst	Gleitlager|Papst
Globalisierungsapostel	Globalisierung|Apostel
Glockenpapst	Glocke|Papst
Glocknerkönig	Glockner|König
Glücksschweine	Glück|Schwein
Goblinkönig	Goblin|König
Goldguru	Gold|Guru
Goldhengst	Gold|Hengst
Goldschwein	Gold|Schwein
Goldwährungsapostel	Goldwährung|Apostel
Golfguru	Golf|Guru
Gotenkönig	Gote|König
Götterdreck	Gott|Dreck
Götterkönig	Gott|König
Gottesapostel	Gott|Apostel
Gottesikone	Gott|Ikone
Gottkönig	Gott|König
Grafikguru	Grafik|Guru
Grafitbolzen	Grafit|Bolzen
Gralskönig	Gral|König
Graphikikone	Graphik|Ikone
Grenzgott	Grenze|Gott
Griechengott	Grieche|Gott
Großkönig	groß|König
Großstadtapostel	Großstadt|Apostel
Großstadtdreck	Großstadt|Dreck
Großstadthengst	Großstadt|Hengst
Gründerapostel	Gründer|Apostel
Gründerhengst	Gründer|Hengst
Grüntrinkerguru	Grüntrinker|Guru
Gruppenguru	Gruppe|Guru
Gruselhengst	gruseln|Hengst
Gruselikone	gruseln|Ikone
grüßgott	Grüß|Gott
Gummibolzen	Gummi|Bolzen
Gummidreck	Gummi|Dreck
Gurkenkönig	Gurke|König
Gurkenpapst	Gurke|Papst
guruguru	Guru|Guru
Gutmenschendreck	Gutmensch|Dreck
Hackerikone	Hacker|Ikone
Hafihengst	Hafi|Hengst
Haflingerhengst	Haflinger|Hengst
Hahnenkönig	Hahn|König
Halbjahresikone	Halbjahr|Ikone
Hallengott	Halle|Gott
Haltbolzen	halten|Bolzen
Haltebolzen	halten|Bolzen
Halterungsbolzen	Halterung|Bolzen
Hamsterdreck	Hamster|Dreck
Handballikone	Handball|Ikone
Hangagott	Hanga|Gott
Hängebauchschweins	Hängebauch|Schwein
Hängebauschweine	Hängebauch|Schweine
Hannoveranerhengst	Hannoveraner|Hengst
Haptagott	Hapta|Gott
Hasenkönig	Hase|König
Hassapostel	Hass|Apostel
Hassbolzen	Hass|Bolzen
Hastgott	Hast|Gott
Hauptapostel	Haupt|Apostel
Hauptbolzen	Haupt|Bolzen
Hauptikone	Haupt|Ikone
Hauptprämienhengst	Hauptprämie|Hengst
Hauptprämiensiegerhengst	Hauptprämiensieger|Hengst
Hauptschwein	Haupt|Schwein
Hausfrauenikone	Hausfrau|Ikone
Hausschwein	Haus|Schwein
Heavy-Metal-Gitarrengott	Heavy-Metal-Gitarre|Gott
Heerkönig	Heer|König
Heidenapostel	Heide|Apostel
Heidenkönig	Heide|König
Heilsapostel	Heil|Apostel
Heilsguru	Heil|Guru
Heilskönig	Heil|König
Heimwerkerkönig	Heimwerker|König
Heizungsguru	Heizung|Guru
Heldengott	Held|Gott
Herdgott	Herd|Gott
Herumbolzen	herum|bolzen
Herzkönig	Herz|König
Hethiterkönig	Hethiter|König
Hetzapostel	Hetze|Apostel
Hexenkönig	Hexe|König
Himmelfahrtsikone	Himmelfahrt|Ikone
Himmelsgott	Himmel|Gott
Himmelskönig	Himmel|König
Hirnbolzen	Hirn|Bolzen
hirtengott	Hirte|Gott
Hirtenkönig	Hirte|König
Hitlergott	Hitler|Gott
Hitparadendreck	Hitparade|Dreck
Hochkönig	hoch|König
Hochleistungsschweine	Hochleistung|Schwein
Hockeygott	Hockey|Gott
Höhenbolzen	Höhe|Bolzen
Hohlbolzen	hohl|Bolzen
Höllenhengst	Hölle|Hengst
Höllenkönig	Hölle|König
Hollywoodikone	Hollywood|Ikone
Holsteinerhengst	Holsteiner|Hengst
Holzbolzen	Holz|Bolzen
Holzikone	Holz|Ikone
Holzschwein	Holz|Schwein
Hormonbolzen	Hormon|Bolzen
Hormonpapst	Hormon|Papst
Horrorikone	Horror|Ikone
Horrorpapst	Horror|Papst
Hörspielpapst	Hörspiel|Papst
Hostapapst	Hosta|Papst
Hotelikone	Hotel|Ikone
Hühnerdreck	Huhn|Dreck
Hülfsgott	Hilfe|Gott
Humanistenpapst	Humanist|Papst
Humanitätsapostel	Humanität|Apostel
Humorbolzen	Humor|Bolzen
Humorhengst	Humor|Hengst
Humorpapst	Humor|Papst
Hundedreck	Hund|Dreck
Hundeguru	Hund|Guru
Hundekönig	Hund|König
Hunnenkönig	Hunne|König
Hüttenschweine	Hütte|Schwein
Hybridikone	hybrid|Ikone
Hygienepapst	Hygiene|Papst
Hypertextguru	Hypertext|Guru
Ideologiebolzen	Ideologie|Bolzen
Ideologiepapst	Ideologie|Papst
Idiotengott	Idiot|Gott
Independentikone	Independent|Ikone
Indianerapostel	Indianer|Apostel
Indieikone	Indie|Ikone
Industriedreck	Industrie|Dreck
Industrieguru	Industrie|Guru
Industrieikone	Industrie|Ikone
Industrieschwein	Industrie|Schwein
Informationspapst	Information|Papst
Informationswissenschaftspapst	Informationswissenschaft|Papst
Ingenieurgott	Ingenieur|Gott
Inhaltsikone	Inhalt|Ikone
Innerlichkeitsapostel	Innerlichkeit|Apostel
Innovationsbolzen	Innovation|Bolzen
Innovationsguru	Innovation|Guru
Insektendreck	Insekt|Dreck
Inselkönig	Insel|König
Instantdreck	instant|Dreck
Integrationsapostel	Integration|Apostel
Intelligenzbolzen	Intelligenz|Bolzen
Internetguru	Internet|Guru
Intoleranzapostel	Intoleranz|Apostel
Investmentguru	Investment|Guru
Investmentikone	Investment|Ikone
Investorenikone	Investor|Ikone
Islandhengst	Island|Hengst
Jagadguru	Jagad|Guru
Jagdgott	Jagd|Gott
Jägergott	Jäger|Gott
Jahresdreck	Jahr|Dreck
Jahresgott	Jahr|Gott
Jahrhundertpapst	Jahrhundert|Papst
Jährlingshengst	Jährling|Hengst
Jahrtausendpapst	Jahrtausend|Papst
jasomirgott	Jasomir|Gott
Jazzpapst	Jazz|Papst
Jelinekdreck	Jelinek|Dreck
Jenseitsapostel	Jenseits|Apostel
Jochbolzen	Joch|Bolzen
Joggingpapst	Jogging|Papst
Judenapostel	Jude|Apostel
Judenkönig	Jude|König
Judenschweinen	Jude|Schwein
Jugendapostel	Jugend|Apostel
Jugendkönig	Jugend|König
Jugendpapst	Jugend|Papst
Junghengst	jung|Hengst
Jungschweines	jung|Schwein
Juristenpapst	Jurist|Papst
Juruguru	UNV
Justizschwein	Justiz|Schwein
Kabarettikone	Kabarett|Ikone
Kadunduguru	UNV
Käfergott	Käfer|Gott
Kaffeeautomatenpapst	Kaffeeautomat|Papst
Kaffeedreck	Kaffee|Dreck
Kaffeekönig	Kaffee|König
Kaffeepapst	Kaffee|Papst
Kaltbluthengst	Kaltblut|Hengst
Kältepapst	Kälte|Papst
Kameldreck	Kamel|Dreck
Kamelhengst	Kamel|Hengst
Kampfesgott	Kampf|Gott
Kampfgott	Kampf|Gott
Kampfhundschwein	Kampfhund|Schwein
Kampfschwein	Kampf|Schwein
Kampfsportikone	Kampfsport|Ikone
Kanaldreck	Kanal|Dreck
Kaninchendreck	Kaninchen|Dreck
Kapitalguru	Kapital|Guru
Kapitalismusapostel	Kapitalismus|Apostel
Kapitalistenschwein	Kapitalist|Schwein
Kapphengst	kappen|Hengst
Karnevalskönig	Karneval|König
Karottenkönig	Karotte|König
Karpfenguru	Karpfen|Guru
Karrierehengst	Karriere|Hengst
Kartoffeldreck	Kartoffel|Dreck
Kartoffelkönig	Kartoffel|König
Kastenschwein	Kasten|Schwein
Katastrophenapostel	Katastrophe|Apostel
Katharerpapst	Katharer|Papst
Katholikenschwein	Katholik|Schwein
Katzendreck	Katze|Dreck
Katzenschwein	Katze|Schwein
Kegelkönig	Kegel|König
Kehrdreck	kehren|Dreck
Keifbolzen	keifen|Bolzen
Keilschwein	Keil|Schwein
Kernbolzen	Kern|Bolzen
Kesselhengst	Kessel|Hengst
Kettenbolzen	Kette|Bolzen
Ketzerkönig	Ketzer|König
Ketzerschweine	Ketzer|Schwein
Kielbolzen	Kiel|Bolzen
Kiezkönig	Kiez|König
Killer-Wildschweinen	Killer|Wildschwein
Kinderkönig	Kind|König
Kindkönig	Kind|König
Kinohengst	Kino|Hengst
Kirchenapostel	Kirche|Apostel
Kirchenpapst	Kirche|Papst
Kitchdreck	Kitsch|Dreck
Kitschbolzen	Kitsch|Bolzen
Klampfengott	Klampfe|Gott
Klassehengst	Klasse|Hengst
Klassenschwein	Klasse|Schwein
Klassenzusammenarbeitsapostel	Klassenzusammenarbeit|Apostel
Klassikerpapst	Klassiker|Papst
Klaviergott	Klavier|Gott
Klebebolzen	Klebe|Bolzen
Klebedreck	Klebe|Dreck
Kleinkönig	klein|König
Kleintierpapst	Kleintier|Papst
Kleinwagenikone	Kleinwagen|Ikone
Klempnergott	Klempner|Gott
Kletterguru	klettern|Guru
Klimaapostel	Klima|Apostel
Klonschweine	klonen|Schwein
Klopphengst	kloppen|Hengst
Knabstrupperhengst	Knabstrupp|Hengst
Knappendreck	Knappe|Dreck
Knochenpapst	Knochen|Papst
Knuddelschwein	knuddeln|Schwein
Kohledreck	Kohle|Dreck
Kohlrabiapostel	Kohlrabi|Apostel
Koko-pok-guru	UNV
Kolbenbolzen	Kolben|Bolzen
Kollegenschweine	Kollege|Schwein
Kommerzdreck	Kommerz|Dreck
Kommunenguru	Kommune|Guru
Kommunikationsguru	Kommunikation|Guru
Komödiengott	Komödie|Gott
Komparsenschwein	Komparse|Schwein
Kompetenzbolzen	Kompetenz|Bolzen
Komponistenguru	Komponist|Guru
Konditionsbolzen	Kondition|Bolzen
Konfliktpapst	Konflikt|Papst
Konservierungsdreck	Konservierung|Dreck
Konsolendreck	Konsole|Dreck
Konsumapostel	Konsum|Apostel
Konusbolzen	Konus|Bolzen
Konzertpapst	Konzert|Papst
Konzilspapst	Konzil|Papst
Kopfbolzen	Kopf|Bolzen
Koppelhengst	Koppel|Hengst
Koptenpapst	Kopte|Papst
Koranapostel	Koran|Apostel
Körperdreck	Körper|Dreck
Körperguru	Körper|Guru
Körperwelten-Ausstellungsguru	Körperweltenausstellung|Guru
Kortisonpapst	Kortison|Papst
Krächzbolzen	krächzen|Bolzen
Kraftapostel	Kraft|Apostel
Kraftbolzen	Kraft|Bolzen
Krähenkönig	Krähe|König
Krankheitsdreck	Krankheit|Dreck
Kratzbolzen	kratzen|Bolzen
Kräuterpapst	Kraut|Papst
Krautrockikone	Krautrock|Ikone
Kreativbolzen	kreativ|Bolzen
Kreativgott	kreativ|Gott
Kreativitätsguru	Kreativität|Guru
Krebsgott	Krebs|Gott
Kreuzigungsikone	Kreuzigung|Ikone
Kreuzkopfbolzen	Kreuzkopf|Bolzen
Kriegspapst	Krieg|Papst
Kritikerguru	Kritiker|Guru
Kritikerpapst	Kritiker|Papst
Kritikpapst	Kritik|Papst
Krokodilkönig	Krokodil|König
Kryptoguru	Krypto|Guru
Kübeldreck	Kübel|Dreck
Küchengott	Küche|Gott
Kugelbolzen	Kugel|Bolzen
Kugelguru	Kugel|Guru
Kühlerikone	Kühler|Ikone
Kuhstalldreck	Kuhstall|Dreck
Kultgott	Kult|Gott
Kultikone	Kult|Ikone
Kulturapostel	Kultur|Apostel
Kulturdreck	Kultur|Dreck
Kulturkampfikone	Kampf|Ikone
Kulturpapst	Kultur|Papst
Kunstapostel	Kunst|Apostel
Kunstdreck	Kunst|Dreck
Kunstfaserdreck	Kunstfaser|Dreck
Kunstguru	Kunst|Guru
Kunstikone	Kunst|Ikone
Kunstpapst	Kunst|Papst
Kunststoffbolzen	Kunststoff|Bolzen
Kupferbolzen	Kupfer|Bolzen
Kuppelbolzen	Kuppel|Bolzen
Kupplungsbolzen	Kupplung|Bolzen
Kurbelwellenbolzen	Kurbelwelle|Bolzen
Kürbiskönig	Kürbis|König
Kuschelguru	kuscheln|Guru
Laborhengst	Labor|Hengst
Laborschweine	Labor|Schwein
Lagerbolzen	Lager|Bolzen
Laienapostel	Laie|Apostel
Lamettahengst	Lametta|Hengst
Landesapostel	Land|Apostel
Landesguru	Land|Guru
Landschweins	Land|Schwein
Landwirtschaftsdreck	Landwirtschaft|Dreck
Langlaufpapst	Langlauf|Papst
Langobardenkönig	Langobarde|König
Lastengott	Last|Gott
Lästerschwein	lästern|Schwein
Latinohengst	Latino|Hengst
Läuferikone	Läufer|Ikone
Läuferschweine	Läufer|Schwein
Laufguru	Lauf|Guru
Laufpapst	laufen|Papst
Lebensdreck	Leben|Dreck
Lebensmittelpapst	Lebensmittel|Papst
Lebensretterschwein	Lebenretter|Schwein
Lederhosenguru	Lederhose|Guru
Leibeigenschaftsapostel	Leibeigenschaft|Apostel
Leidensgott	Leiden|Gott
Leihhengst	leihen|Hengst
Leinwandikone	Leinwand|Ikone
Leistungsapostel	Leistung|Apostel
Leistungshengst	Leistung|Hengst
Leithengst	leiten|Hengst
Leitikone	leiten|Ikone
Lesbenikone	Lesbe|Ikone
Lesekönig	lesen|König
Leuchtschweins	leuchten|Schwein
Leuenkönig	Leu|König
Lichkönig	Lich|König
Lichtapostel	Licht|Apostel
Liebesapostel	Liebe|Apostel
Liebesgott	Liebe|Gott
Liebesschwein	Liebe|Schwein
Lieblingsapostel	Liebling|Apostel
Lieblingsgott	Liebling|Gott
Lieblingshengst	Liebling|Hengst
Lieblingsikone	Liebling|Ikone
Lieblingspapst	Liebling|Papst
Lieblingsschwein	Liebling|Schwein
Liederpapst	Lied|Papst
Limbogott	Limbo|Gott
Linguistenpapst	Linguist|Papst
Linienrichtergott	Linienrichter|Gott
Lipizzanerhengst	Lippizaner|Hengst
Literaturikone	Literatur|Ikone
Literaturpapst	Literatur|Papst
Logistikpapst	Logistik|Papst
Lohnzurückhaltungsapostel	Lohnzurückhaltung|Apostel
Lottokönig	Lotto|König
Löwengott	Löwe|Gott
Löwenkönig	Löwe|König
Lückenfüllergott	Lückenfüller|Gott
Luderdreck	Luder|Dreck
Luftkönig	Luft|König
Luftpapst	Luft|Papst
Lügenapostel	Lüge|Apostel
Lügenbolzen	Lüge|Bolzen
Lügendreck	Lüge|Dreck
Lukasikone	Lukas|Ikone
Lusitanohengst	Lusitano|Hengst
Lustbolzen	Lust|Bolzen
Lusthengst	Lust|Hengst
Luxusikone	Luxus|Ikone
Lyderkönig	Lyder|König
Lyrikgott	Lyrik|Gott
Lyrikikone	Lyrik|Ikone
Madonnenikone	Madonna|Ikone
Makedonenkönig	Makedone|König
Malerschweins	Maler|Schwein
Managementguru	Management|Guru
Mangalizaschwein	Mangaliza|Schwein
Manierenpapst	Manier|Papst
Männerapostel	Mann|Apostel
Männerikone	Mann|Ikone
Männlichkeitsikone	Männlichkeit|Ikone
Manöverdreck	Manöver|Dreck
Märchenkönig	Märchen|König
Märchenpapst	Märchen|Papst
Marienikone	Maria|Ikone
Marienpapst	Maria|Papst
Marionettenpapst	Marionette|Papst
Markenikone	Marke|Ikone
Markenschwein	Marke|Schwein
Marketingdreck	Marketing|Dreck
Marketingguru	Marketing|Guru
Marketingpapst	Marketing|Papst
Marktapostel	Markt|Apostel
Marktgott	Markt|Gott
Markusikone	Markus|Ikone
Marmorapostel	Marmor|Apostel
Marmorgott	Marmor|Gott
Marzipanschweine	Marzipan|Schwein
Maskenguru	Maske|Guru
Maskenschweinen	Maske|Schwein
Mäßigkeitsapostel	Mäßigkeit|Apostel
Mastschweins	Mast|Schwein
Maurenkönig	Maure|König
Maurersdreck	Maurer|Dreck
Mausdreck	Maus|Dreck
Mäusedreck	Maus|Dreck
Mausekönig	Maus|König
Mäusekönig	Maus|König
Meckerbolzen	meckern|Bolzen
Medicipapst	Medici|Papst
Medienapostel	Medium|Apostel
Mediendreck	Medium|Dreck
Mediengott	Medium|Gott
Medienguru	Medium|Guru
Medienhengst	Medium|Hengst
Medienpapst	Medium|Papst
Medizinpapst	Medizin|Papst
Meeresgott	Meer|Gott
Meereskönig	Meer|König
Meerhengst	Meer|Hengst
Meerkönig	Meer|König
Meerschweins	Meer|Schwein
Meinungsdreck	Meinung|Dreck
Meinungshengst	Meinung|Hengst
Memoirendreck	Memoiren|Dreck
Menschenrechtsapostel	Menschenrecht|Apostel
Menschheitsapostel	Menschheit|Apostel
Menschschweine	Mensch|Schwein
Merchandisedreck	Merchandise|Dreck
Merowingerkönig	Merowinger|König
Messepapst	Messe|Papst
Messiaskönig	Messias|König
Messingbolzen	Messing|Bolzen
Metallbolzen	Metall|Bolzen
Metallikone	Metall|Ikone
Metallschwein	Metall|Schwein
Milbendreck	Milbe|Dreck
Militärikone	Militär|Ikone
Millionenhengst	Million|Hengst
Minenguru	Mine|Guru
Miniaturguru	Miniatur|Guru
Minihengst	mini|Hengst
Minischweinen	mini|Schwein
Minischwein	mini|Schwein
Ministeriumshengst	Ministerium|Hengst
Minusgott	Minus|Gott
Mistapostel	Mist|Apostel
Mistbolzen	Mist|Bolzen
Mithrilbolzen	Mithril|Bolzen
Moabiterkönig	Moabiter|König
Mobilitätsikone	Mobilität|Ikone
Möchtegernguru	Möchtegern|Guru
Möchtgernhengst	Möchtegern|Hengst
Modeguru	Mode|Guru
Modeikone	Mode|Ikone
Modellbahnpapst	Modellbahn|Papst
Modepapst	Mode|Papst
Modernisierungspapst	Modernisierung|Papst
Modernitätsikone	Modernität|Ikone
Moerderpapst	Mörder|Papst
Mohrenkönig	Mohr|König
Mönchsgott	Mönch|Gott
Mönchspapst	Mönch|Papst
Monddreck	Mond|Dreck
Mondkönig	Mond|König
Monsterdreck	Monster|Dreck
Montagebolzen	Montage|Bolzen
Moorkönig	Moor|König
Moralapostel	Moral|Apostel
Moralbolzen	Moral|Bolzen
Moralpapst	Moral|Papst
Moralsapostel	Moral|Apostel
Mormonenapostel	Mormone|Apostel
Mörteldreck	Mörtel|Dreck
Mosaikikone	Mosaik|Ikone
Moslemdreck	Moslem|Dreck
Motivationsguru	Motivation|Guru
Motorbefestigungsbolzen	Motorbefestigung|Bolzen
Motorenpapst	Motor|Papst
Motorradhengst	Motorrad|Hengst
Motorsportikone	Motorsport|Ikone
Mövendreck	Möve|Dreck
Möwendreck	Möwe|Dreck
Mückendreck	Mücke|Dreck
Müllkönig	Müll|König
Müllschwein	Müll|Schwein
Multikultidreck	Multikulti|Dreck
Multimediapapst	Multimedia|Papst
Mumienkönig	Mumie|König
Musicalpapst	Musical|Papst
Musikantenkönig	Musikant|König
Musikbolzen	Musik|Bolzen
Musikdreck	Musik|Dreck
Musikerikone	Musiker|Ikone
Musikgott	Musik|Gott
Musikguru	Musik|Guru
Musikikone	Musik|Ikone
Mustanghengst	Mustang|Hengst
Mutterikone	Mutter|Ikone
Mütterlichkeitsikone	Mütterlichkeit|Ikone
Mutterschweinen	Mutter|Schwein
Nachbarschweinen	Nachbar|Schwein
Nachbarshengst	Nachbar|Hengst
Nachfrageapostel	Nachfrage|Apostel
Nachhaltigkeitsapostel	Nachhaltigkeit|Apostel
Nachkriegsdreck	Nachkriegs|Dreck
Nachrichtenikone	Nachricht|Ikone
Nachtclubhengst	Nachtclub|Hengst
Nachthengst	Nacht|Hengst
Nachtlebenikone	Nachtleben|Ikone
Nachwuchshengst	Nachwuchs|Hengst
Nacktikone	nackt|Ikone
Nageldreck	Nagel|Dreck
Nahrungsgdreck	Nahrung|Dreck
Narrenbolzen	Narr|Bolzen
Narrenkönig	Narr|König
Narrenpapst	Narr|Papst
Nasenpapst	Nase|Papst
Nationalgott	national|Gott
Nationalikone	national|Ikone
Naturalistenpapst	Naturalist|Papst
Naturapostel	Natur|Apostel
Naturgott	Natur|Gott
Natürlichkeitsapostel	Natürlichkeit|Apostel
Nazidreck	Nazi|Dreck
Negativgott	Negativ|Gott
Negerdreck	Neger|Dreck
Negerpapst	Neger|Papst
Nervbolzen	Nerv|Bolzen
Nervenbolzen	Nerv|Bolzen
Netzapostel	Netz|Apostel
Netzguru	Netz|Guru
Netzwerkpapst	Netzwerk|Papst
Neujahrsdreck	Neujahr|Dreck
Neutralitätsapostel	Neutralität|Apostel
Nichtgott	nicht|Gott
Nichthengst	nicht|Hengst
Nichtschweine	nicht|Schwein
Nietbolzen	Niet|Bolzen
Nintendodreck	Nintendo|Dreck
Norikerhengst	Noriker|Hengst
Normannenkönig	Normanne|König
Numiderkönig	Numider|König
Nutzfahrzeugikone	Nutzfahrzeug|Ikone
Nutzschweinen	Nutz|Schwein
Oberbolzen	ober|Bolzen
Oberflächendreck	Oberfläche|Dreck
Oberguru	ober|Guru
Oberpapst	ober|Papst
Oberschweine	ober|Schwein
Objektivapostel	Objektiv|Apostel
Obstguru	Obst|Guru
Oder-bolzen	Oder|Bolzen
Ofenpapst	Ofen|Papst
Offenbarungsgott	Offenbarung|Gott
Ökoapostel	Öko|Apostel
Operettendreck	Operette|Dreck
Operettenkönig	Operette|König
Opfergott	Opfer|Gott
Opferikone	Opfer|Ikone
Orakelgott	Orakel|Gott
Orakelschwein	Orakel|Schwein
Orangeguru	Orange|Guru
Orbitdreck	Orbit|Dreck
Organisationsguru	Organisation|Guru
Organschwein	Organ|Schwein
Originaldreck	original|Dreck
Osterikone	Ostern|Ikone
Osterschweinen	Ostern|Schwein
Ostgotenkönig	Ostgoten|König
Otterkönig	Otter|König
Pacellipapst	Pacelli|Papst
Pachthengst	Pacht|Hengst
Pädagogikpapst	Pädagogik|Papst
Paddelpapst	Paddel|Papst
Paidmaildreck	Paidmail|Dreck
Palominohengst	Palomino|Hengst
Pampelschwein	Pampel|Schwein
Panthergott	Panther|Gott
Panzerpapst	Panzer|Papst
Papierkönig	Papier|König
Papierpapst	Papier|Papst
Paragrafenhengst	Paragraf|Hengst
Parkinsonpapst	Parkinson|Papst
Parteibuchhengst	Parteibuch|Hengst
Parteiendreck	Partei|Dreck
Parteihengst	Partei|Hengst
Parteilichkeitsapostel	Parteilichkeit|Apostel
Parteipapst	Partei|Papst
Partnerhengst	Partner|Hengst
Partyhengst	Party|Hengst
Partykönig	Party|König
Passbolzen	Pass|Bolzen
Passivhauspapst	Passivhaus|Papst
Patentdreck	Patent|Dreck
Patientenguru	Patient|Guru
Patronatsikone	Patronat|Ikone
Pegasushengst	Pegasus|Hengst
Peilbolzen	peilen|Bolzen
Penetranzbolzen	Penetranz|Bolzen
Perserkönig	Perser|König
Personengott	Person|Gott
Petrolpapst	Petrol|Papst
Pfeifbolzen	pfeifen|Bolzen
Pfeifenpapst	Pfeife|Papst
Pferdedreck	Pferd|Dreck
Pferdeguru	Pferd|Guru
Pferdehengst	Pferd|Hengst
Pferdepapst	Pferd|Papst
Pfingstapostel	Pfingsten|Apostel
Pfingstdreck	Pfingsten|Dreck
Pflegergott	Pfleger|Gott
Pfostenbolzen	Pfosten|Bolzen
Pfützendreck	Pfütze|Dreck
Pharmadreck	Pharma|Dreck
Philosophengott	Philosoph|Gott
Philosophenkönig	Philosoph|König
Phönixkönig	Phönix|König
Phrasenschwein	Phrase|Schwein
Physikguru	Physik|Guru
Physikpapst	Physik|Papst
Pilzbolzen	Pilz|Bolzen
Pilzkönig	Pilz|König
Pilzpapst	Pilz|Papst
Pintohengst	Pinto|Hengst
Piratenkönig	Pirat|König
Piratenschwein	Pirat|Schwein
Pixelapostel	Pixel|Apostel
Pixeldreck	Pixel|Dreck
Pixelpapst	Pixel|Papst
Plasmabolzen	Plasma|Bolzen
Plastikbolzen	Plastik|Bolzen
Plastikdreck	Plastik|Dreck
Plastikikone	Plastik|Ikone
Platinbolzen	Platin|Bolzen
Plättbolzen	plätten|Bolzen
Plattenapostel	Platte|Apostel
Plattenpapst	Platte|Papst
Plüschschwein	Plüsch|Schwein
Polenkönig	Pole|König
Polenpapst	Pole|Papst
Politguru	Polit|Guru
Politikguru	Politik|Guru
Politikschweine	Politik|Schwein
Polizeigott	Polizei|Gott
Polizistenschweine	Polizist|Schwein
Poltergott	poltern|Gott
Polygott	UNV
Pomadenhengst	Pomade|Hengst
Pommernapostel	Pommern|Apostel
Popdichterikone	Popdichter|Ikone
Populärkulturguru	Populärkultur|Guru
Pornodreck	Porno|Dreck
Pornohengst	Porno|Hengst
Pornokönig	Porno|König
Porzellangott	Porzellan|Gott
Porzellanschwein	Porzellan|Schwein
Possenkönig	Posse|König
Posterikone	Poster|Ikone
Potenzbolzen	Potenz|Bolzen
Potenzhengst	Potenz|Hengst
Prachthengst	Pracht|Hengst
Prachtschweine	Pracht|Schwein
Praktikantendreck	Praktikant|Dreck
Prämienhengst	Prämie|Hengst
Preßbolzen	pressen|Bolzen
Presseschweine	Presse|Schwein
Preußenkönig	Preußen|König
Preußenschwein	Preuße|Schwein
Priesterkönig	Priester|König
Printpapste	Print|Papst
Privatguru	privat|Guru
Privathengst	privat|Hengst
Privilegienschwein	Privilegium|Schwein
Probierhengst	probieren|Hengst
Produktionsgott	Produktion|Gott
Produzentengott	Produzent|Gott
Produzentenguru	Produzent|Guru
Programmiererschwein	Programmierer|Schwein
Projektorenpapsts	Projektor|Papst
Propellerhengst	Propeller|Hengst
Protestschwein	Protest|Schwein
Prothesenpapst	Prothese|Papst
Prozessikone	Prozess|Ikone
Pseudoapostel	Pseudo|Apostel
Pseudopapst	Pseudo|Papst
Psychiaterguru	Psychiater|Guru
Psychoguru	Psycho|Guru
Psychologenpapst	Psychologe|Papst
Psychopathenschwein	Psychopath|Schwein
Pudelkönig	Pudel|König
Punkerschwein	Punker|Schwein
Puppenkönig	Puppe|König
Pustelschweine	Pustel|Schwein
Quarterhengst	Quarter|Hengst
Querbolzen	quer|Bolzen
Querkraftbolzen	Querkraft|Bolzen
Quermutterbolzen	Quermutter|Bolzen
Quotenkönig	Quote|König
Quotenpapst	Quote|Papst
Rabengott	Rabe|Gott
Rabenkönig	Rabe|König
Rachepapst	Rache|Papst
Radiogott	Radio|Gott
Radioikone	Radio|Ikone
Radiopapst	Radio|Papst
Radsportikone	Radsport|Ikone
Rappenhengst	Rappe|Hengst
Rassehengst	Rasse|Hengst
Rassistenschwein	Rassist|Schwein
Rationalisierungspapst	Rationalisierung|Papst
Rätselkönig	Rätsel|König
Rattendreck	Ratte|Dreck
Rattengott	Ratte|Gott
Rattenkönig	Ratte|König
Ratzipapst	Ratzi|Papst
Raubapostel	Raub|Apostel
Raucherdreck	Raucher|Dreck
Rechenkönig	rechnen|König
Rechtsdreck	Recht|Dreck
Redeverbotsapostel	Redeverbot|Apostel
Reformapostel	Reform|Apostel
Reformguru	Reform|Guru
Reformpapst	Reform|Papst
Reformpapsts	Reform|Papst
Reformschweine	Reform|Schwein
Regelhengst	Regel|Hengst
Regelpapst	Regel|Papst
Regenkönig	Regen|König
Regieguru	Regie|Guru
Reinheitsapostel	Reinheit|Apostel
Reiseapostel	Reise|Apostel
Reisedreck	Reise|Dreck
Reiseführergott	Reiseführer|Gott
Reiseguru	Reise|Guru
Reisepapst	Reise|Papst
Reithengst	reiten|Hengst
Reitpferdehengst	Reitpferd|Hengst
Reitponyhengst	Reitpony|Hengst
Reitschwein	reiten|Schwein
Reliefikone	Relief|Ikone
Religionsapostel	Religion|Apostel
Religionsdreck	Religion|Dreck
Remiskönig	Remis|König
Renaissancepapst	Renaissance|Papst
Renegatenschweine	Renegat|Schwein
Rennfahrerikone	Rennfahrer|Ikone
Rentenpapst	Rente|Papst
Reserveschlagbolzen	Reserveschlag|Bolzen
Restdreck	Rest|Dreck
Rettungsguru	Rettung|Guru
Revierhengst	Revier|Hengst
Rheinländerhengst	Rheinländer|Hengst
Rhetorikguru	Rhetorik|Guru
Richtergott	Richter|Gott
Richterschwein	Richter|Schwein
Riegelbolzen	Riegel|Bolzen
Riesenbolzen	Riese|Bolzen
Riesenhengst	Riese|Hengst
Riesenkönig	Riese|König
Riesenschwein	Riese|Schwein
Riffbolzen	Riff|Bolzen
Rindergott	Rind|Gott
Rindschweine	Rind|Schwein
Ringbolzen	Ring|Bolzen
Ringerikone	Ringer|Ikone
Rinnsteindreck	Rinnstein|Dreck
Ritzendreck	Ritze|Dreck
Rockikone	Rock|Ikone
Rockpapst	Rock|Papst
Rockschwein	Rock|Schwein
Rohkostguru	Rohkost|Guru
Rohkostpapst	Rohkost|Papst
Rollenhengst	Rolle|Hengst
Rollschweinen	rollen|Schwein
Rosenkönig	Rose|König
Rotlichtkönig	Rotlicht|König
Rotorbolzen	Rotor|Bolzen
Rotzdreck	Rotz|Dreck
Rübenkönig	Rübe|König
Ruhrgebietsikone	Ruhrgebiet|Ikone
Ruhrpottikone	Ruhrpott|Ikone
Rundbolzen	rund|Bolzen
Rüsselschweine	Rüssel|Schwein
Russenhengst	Russe|Hengst
Russenikone	Russe|Ikone
Saatengott	Saat|Gott
Sachsenkönig	Sachse|König
Sachsenschwein	Sachse|Schwein
Sambagott	Samba|Gott
Sängerikone	Sänger|Ikone
Sängerpapst	Sänger|Papst
Satuguru	Satu|Guru
Säulenapostel	Säule|Apostel
Schachkönig	Schach|König
Schäferschwein	Schäfer|Schwein
Schaftbolzen	Schaft|Bolzen
Schakalgott	Schakal|Gott
Schälhengst	schälen|Hengst
Scharnierbolzen	Scharnier|Bolzen
Schattenbolzen	Schatten|Bolzen
Schattengott	Schatten|Gott
Schattenkönig	Schatten|König
Schauspielerikone	Schauspieler|Ikone
Schauspielguru	Schauspiel|Guru
Schauspielikone	Schauspiel|Ikone
Scheckhengst	Scheck|Hengst
Scheingott	Schein|Gott
Scherbolzen	scheren|Bolzen
Schiebebolzen	schieben|Bolzen
Schiedsrichterschwein	Schiedsrichter|Schwein
Schießbolzen	schießen|Bolzen
Schimmelhengst	Schimmel|Hengst
Schinkengott	Schinken|Gott
Schismapapst	Schisma|Papst
Schlafdreck	Schlaf|Dreck
Schlagbolzen	Schlag|Bolzen
Schlagerapostel	Schlager|Apostel
Schlagfertigkeitspapst	Schlagfertigkeit|Papst
Schlammschwein	Schlamm|Schwein
Schlangenkönig	Schlange|König
Schleimbolzen	Schleim|Bolzen
Schlichtheitsapostel	Schlichtheit|Apostel
Schließbolzen	schließen|Bolzen
Schließringbolzen	Schließring|Bolzen
Schlitzhengst	Schlitz|Hengst
Schmachtbolzen	schmachten|Bolzen
Schmierdreck	schmieren|Dreck
Schmökerschwein	Schmöker|Schwein
Schmugglerkönig	Schmuggler|König
Schneckenhengst	Schnecke|Hengst
Schneckenpapst	Schnecke|Papst
Schneedreck	Schnee|Dreck
Schneekönig	Schnee|König
Schnullerschwein	Schnuller|Schwein
Schokoladenschweine	Schokolade|Schwein
Schönheitsapostel	Schönheit|Apostel
Schönheitsikone	Schönheit|Ikone
Schönheitspapst	Schönheit|Papst
Schönhengst	schön|Hengst
Schöpfergott	Schöpfer|Gott
Schraubbolzen	schrauben|Bolzen
Schraubenbolzen	Schraube|Bolzen
Schraubendreck	Schraube|Dreck
Schreckenskönig	Schrecken|König
Schreibergott	Schreiber|Gott
Schreibguru	schreiben|Guru
Schreibstubenhengst	Schreibstube|Hengst
Schreibtischhengst	Schreibtisch|Hengst
Schreissdreck	Schreiss|Dreck
Schriftgott	Schrift|Gott
Schriftikone	Schrift|Ikone
Schrottgott	Schrott|Gott
Schuldapostel	Schuld|Apostel
Schuldenkönig	Schuld|König
Schulhengst	Schule|Hengst
Schulikone	Schule|Ikone
Schussbolzen	Schuss|Bolzen
Schußbolzen	Schuss|Bolzen
Schützengrabendreck	Schützengraben|Dreck
Schützenkönig	Schütze|König
Schwalbengott	Schwalbe|Gott
Schwalbenkönig	Schwalbe|König
Schwammerlguru	Schwammerl|Guru
Schwanenkönig	Schwan|König
Schwedenhengst	Schwede|Hengst
Schwedenkönig	Schwede|König
Schweinedreck	Schwein|Dreck
Schweißhengst	Schweiß|Hengst
Schweizerapostel	Schweizer|Apostel
Schweizerikone	Schweizer|Ikone
Schwertbolzen	Schwert|Bolzen
Schwingenlagerbolzen	Schwingelager|Bolzen
Schwulenikone	Schwuler|Ikone
Seelenguru	Seele|Guru
Seelsorgepapst	Seelsorge|Papst
Segelikone	Segel|Ikone
Sehergott	Seher|Gott
Seifengott	Seife|Gott
Seitenbolzen	Seite|Bolzen
Sektenapostel	Sekte|Apostel
Sektengott	Sekte|Gott
Sektenguru	Sekte|Guru
Selbsthilfeguru	Selbsthilfe|Guru
Selbstjustizikone	Selbstjustiz|Ikone
Septemberpapst	September|Papst
Seriendreck	Serie|Dreck
Serienikone	Serie|Ikone
Setzbolzen	setzen|Bolzen
Seucheschweinen	Seuche|Schwein
Sexualpapst	sexual|Papst
Shetlandponyhengst	Shetlandpony|Hengst
Shettyjährlingshengst	Shettyjährling|Hengst
Showhengst	Show|Hengst
Sicherheitsapostel	Sicherheit|Apostel
Sicherheitsbolzen	Sicherheit|Bolzen
Sicherheitspapst	Sicherheit|Papst
Sicherungsbolzen	Sicherung|Bolzen
Siegerhengst	Sieger|Hengst
Sikhguru	Sikh|Guru
Silberhengst	Silber|Hengst
Sitcomikone	Sitcom|Ikone
Sittenapostel	Sitte|Apostel
Sittlichkeitsapostel	Sittlichkeit|Apostel
Sitzgurtbolzen	Sitzgurt|Bolzen
Skandalikone	Skandal|Ikone
Skaterikone	Skater|Ikone
Skilaufikone	Skilauf|Ikone
Slawenapostel	Slawe|Apostel
Smartmarkguru	Smartmark|Guru
Softiegott	Softie|Gott
Softwaredreck	Software|Dreck
Softwarepapst	Software|Papst
Sohnesgott	Sohn|Gott
Solarenergiepapst	Solarenergie|Papst
Solarpapst	solar|Papst
Soldatenkönig	Soldat|König
Soldatenschwein	Soldat|Schwein
Söldnerschweinen	Söldner|Schwein
Sommergott	Sommer|Gott
Sondergott	Sonder|Gott
Songwriterikone	Songwriter|Ikone
Sonnenfinsternispapst	Sonnenfinsternis|Papst
Sonnenkönig	Sonne|König
Sonnenpapst	Sonne|Papst
Soundguru	Sound|Guru
Sozialapostel	sozial|Apostel
Sozialdreck	sozial|Dreck
Sozialpapst	sozial|Papst
Sozialstaatsapostel	Sozialstaat|Apostel
Sozipapst	Sozi|Papst
Spannbolzen	spannen|Bolzen
Sparapostel	sparen|Apostel
Sparschweines	sparen|Schwein
Spartanerkönig	Spartaner|König
Spatzendreck	Spatz|Dreck
Spatzenpapst	Spatz|Papst
Sperrbolzen	sperren|Bolzen
Sperrmüllkönig	Sperrmüll|König
Spieleguru	Spiel|Guru
Spieleikone	Spiel|Ikone
Spielerikone	Spieler|Ikone
Spielgott	Spiel|Gott
Spielschwein	Spiel|Schwein
Spielzeitikone	Spielzeit|Ikone
Spießerschweine	Spießer|Schwein
Spitzenhengst	Spitze|Hengst
Splatterfilmguru	Splatterfilm|Guru
Splattergott    Splatter|Gott
Splatterguru	Splatter|Guru
Splatterpapst	Splatter|Papst
Sportapostel	Sport|Apostel
Sportguru	Sport|Guru
Sporthengst	Sport|Hengst
Sportikone	Sport|Ikone
Sportlerhengst	Sportler|Hengst
Sportpapst	Sport|Papst
Sportschwein	Sport|Schwein
Sprachdreck	Sprache|Dreck
Sprachikone	Sprache|Ikone
Sprachpapst	Sprache|Papst
Spreizbolzen	spreizen|Bolzen
Sprengbolzen	sprengen|Bolzen
Sprengikone	sprengen|Ikone
Springhengst	springen|Hengst
Springschweine	springen|Schwein
Sprintkönig	Sprint|König
Sprühdosenwandbildgott	Sprühdosenwandbild|Gott
Staatsikone	Staat|Ikone
Stabilitätsapostel	Stabilität|Apostel
Stadtikone	Stadt|Ikone
Stadtteilikone	Stadtteil|Ikone
Staffageschweine	Staffage|Schwein
Stahlbolzen	Stahl|Bolzen
Stalldreck	Stall|Dreck
Stammapostel	Stamm|Apostel
Stammbolzen	Stamm|Bolzen
Stammesgott	Stamm|Gott
Standortdreck	Standort|Dreck
Starapostel	Star|Apostel
Starikone	Star|Ikone
Startdreck	Start|Dreck
Stasischwein	Stasi|Schwein
Statistikapostel	Statistik|Apostel
Statistikguru	Statistik|Guru
Stauferkönig	Staufer|König
Steckbolzen	stecken|Bolzen
Stehbolzen	stehen|Bolzen
Steinapostel	Stein|Apostel
Stempelhengst	Stempel|Hengst
Steppenhengst	Steppe|Hengst
Steppenzebrahengst	Steppenzebra|Hengst
Sternenguru	Stern|Guru
Sternenkönig	Stern|König
Sterngott	Stern|Gott
Steuermoralapostel	Steuermoral|Apostel
Steuerpapst	Steuer|Papst
Stiergott	Stier|Gott
Stilikone	Stil|Ikone
Stimmenkönig	Stimme|König
Stimmungsdreck	Stimmung|Dreck
Stinktierdreck	Stinktier|Dreck
Stinthengst	Stint|Hengst
Strahlendreck	Strahl|Dreck
Strahlenpapst	Strahl|Papst
Straßenbahnpapst	Straßenbahn|Papst
Straßenhengst	Straße|Hengst
Strategieguru	Strategie|Guru
Streetartikone	Streetart|Ikone
streetballgott	Streetball|Ikone
Streithengst	Streit|Hengst
Stromgott	Strom|Gott
Stummfilmikone	Stummfilm|Ikone
Sturmgott	Sturm|Gott
Sturmkönig	Sturm|König
Substanzapostel	Substanz|Apostel
Suchtbolzen	Sucht|Bolzen
Sumpfschwein	Sumpf|Schwein
Sündendreck	Sünde|Dreck
Superdreck	super|Dreck
Superguru	super|Guru
Superhengst	super|Hengst
Superpromihengst	Superpromi|Hengst
Superschwein	super|Schwein
Surferikone	Surfer|Ikone
Sylvesterhengst	Sylvester|Hengst
Symandreck	UNV
Sympathiebolzen	Sympathie|Bolzen
Synchronisationsikone	Synchronisation|Ikone
Synthiegott	Synthie|Gott
Systemguru	System|Guru
Szeneikone	Szene|Ikone
Taktikguru	Taktik|Guru
Tankerkönig	Tanker|König
Tanztheaterikone	Tanztheater|Ikone
Tastenguru	Taste|Guru
Tastenhengst	Taste|Hengst
Taubendreck	Taube|Dreck
Tauchsportikone	Tauchsport|Ikone
Taufgott	taufen|Gott
Technikapostel	Technik|Apostel
Technikguru	Technik|Guru
Technikikone	Technik|Ikone
Tempeldreck	Tempel|Dreck
Tempelgott	Tempel|Gott
Temperamentsbolzen	Temperament|Bolzen
Tempobolzen	Tempo|Bolzen
Tendaguru	UNV
Tennisguru	Tennis|Guru
Tennisikone	Tennis|Ikone
Terragigaguru	Terragiga|Guru
Terrorguru	Terror|Guru
Testosteronbolzen	Testosteron|Bolzen
Teufelsbolzen	Teufel|Bolzen
Teufelsdreck	Teufel|Dreck
Teufelshengst	Teufel|Hengst
Teutonenschweine	Teutone|Schwein
Textilguru	textil|Guru
Textilikone	extil|Ikone
Theaterguru	Theater|Guru
Theaterikone	Theater|Ikone
Theorieguru	Theorie|Guru
Therapieguru	Therapie|Guru
Tierrechtsapostel	Tierrecht|Apostel
Tierschutzguru	Tierschutz|Guru
Tigergott	Tiger|Gott
Tigerscheckhengst	Tigerschecken|Hengst
Tinkerhengst	Tinker|Hengst
Titularkönig	Titular|König
Toleranzapostel	Toleranz|Apostel
Torfschwein	Torf|Schwein
Torschützenkönig	Torschütze|König
Torwartgott	Torwart|Gott
Torwartikone	Torwart|Ikone
Tourismusguru	Tourismus|Guru
Touristenikone	Tourist|Ikone
Trainerguru	Trainer|Guru
Trainerikone	Trainer|Ikone
Trakehnerhengst	Trakehner|Hengst
Trampeltierhengst	Trampeltier|Hengst
Transportbolzen	Transport|Bolzen
Transsexuellenikone	Transsexueller|Ikone
Traufgott	Traufe|Gott
Traugott	trauen|Gott
Traumhengst	Traum|Hengst
Traumkönig	Traum|König
Treckerdreck	Trecker|Dreck
Trendguru	Trend|Guru
Trennbolzen	trennen|Bolzen
Tresorbolzen	Tresor|Bolzen
Trickfilmikone	Trickfilm|Ikone
Tricksergott	Trickser|Gott
Trolldreck	Troll|Dreck
Trollkönig	Troll|König
Trommelgott	Trommel|Gott
Trommelguru	Trommel|Guru
Trompetenguru	Trompete|Guru
Trompetenschwein	Trompete|Schwein
Trüffelguru	Trüffel|Guru
Trüffelschweinen	Trüffel|Schwein
Trümmerdreck	Trümmer|Dreck
Tugendapostel	Tugend|Apostel
Turbohengst	Turbo|Hengst
Türbolzen	Türe|Bolzen
Turboschweinen	Turbo|Schwein
Türkendreck	Türke|Dreck
Türkenkönig	Türke|König
Türkenschwein	Türke|Schwein
Turnierhengst	Turnier|Hengst
Twitterdreck	Twitter|Dreck
Überguru	über|Guru
Überübergott	über|Gott
Uhrenikone	Uhr|Ikone
Umweltapostel	Umwelt|Apostel
Umweltdreck	Umwelt|Dreck
Unabhängigkeitsapostel	Unabhängigkeit|Apostel
Undergroundguru	Underground|Guru
Ungarnkönig	Ungarn|König
Ungarschwein	Ungar|Schwein
Unionskönig	Union|König
Unterdrückerschwein	Unterdrücker|Schwein
Untergangsapostel	Untergang|Apostel
Untergott	unter|Gott
Unterhaltungsdreck	Unterhaltung|Dreck
Unterhaltungsikone	Unterhaltung|Ikone
Unterkönig	unter|König
Unterweltkönig	Unterwelt|König
Urschöpfergott	Urschöpfer|Gott
Urschuhapostel	Urschuh|Apostel
Urwaldgott	Urwald|Gott
Vandalenkönig	Vandale|König
Vätergott	Vater|Gott
Vaterhengst	Vater|Hengst
Vaterschweine	Vater|Schwein
Verankerungsbolzen	Verankerung|Bolzen
Veranstaltungsguru	Veranstaltung|Guru
Verbalikone	Verbal|Ikone
Verbandshengst	Verband|Hengst
Verbindungsbolzen	Verbindung|Bolzen
Verbotsapostel	Verbot|Apostel
Verbrecherkönig	Verbrecher|König
Verdummungsapostel	Verdummung|Apostel
Vereinsdreck	Verein|Dreck
Verkehrsgott	Verkehr|Gott
Verkehrsguru	Verkehr|Guru
Verklärungsikone	Verklärung|Ikone
Verlustschwein	Verlust|Schwein
Vernunftapostel	Vernunft|Apostel
Verriegelungsbolzen	Verriegelung|Bolzen
Verschlussbolzen	Verschluss|Bolzen
Verschlußbolzen	Verschluss|Bolzen
Verschraubungsbolzen	Verschraubung|Bolzen
Versöhnergott	Versöhnener|Gott
Versöhnungsapostel	Versöhnung|Apostel
Versuchsschweinen	Versuch|Schwein
Vertäuensbolzen	vertäuen|Bolzen
Verwaltungshengst	Verwaltung|Hengst
Verzichtsapostel	Verzicht|Apostel
Verzückungsgott	Verzückung|Gott
Vicekönig	Vice|König
Videospielikone	Videospiel|Ikone
Vierkantbolzen	Vierkant|Bolzen
vinylguru	Vinyl|Guru
Virginitätsapostel	Virginität|Apostel
Visionsapostel	Vision|Apostel
Vitalitätsbolzen	Vitalität|Bolzen
Vitaminapostel	Vitamin|Apostel
Vitaminguru	Vitamin|Guru
Vizeguru	Vize|Guru
Vizekönig	Vize|König
Vogelkönig	Vogel|König
Völkerapostel	Volk|Apostel
Volksdreck	Volk|Dreck
Volkskönig	Volk|König
Volkswirtschaftsapostel	Volkswirtschaft|Apostel
Vollblutaraberhengst	Vollblutaraber|Hengst
Vollbluthengst	Vollblut|Hengst
Vollschweinen	voll|Schwein
Voltigierhengst	voltigieren|Hengst
Vorschriftenhengst	Vorschrift|Hengst
Vorstandsschweine	Vorstand|Schwein
Wachstumsapostel	Wachstum|Apostel
Wachtelkönig	Wachtel|König
Wackeldreck	wackeln|Dreck
Wahlkönig	Wahl|König
Wahlrechtsguru	Wahlrecht|Guru
Wahrheitsapostel	Wahrheit|Apostel
Walddreck	Wald|Dreck
Waldesgott	Wald|Gott
Waldkönig	Wald|König
Waldorfguru	Waldorf|Guru
Walzerkönig	Walzer|König
Wanderapostel	wandern|Apostel
Wanderguru	wandern|Guru
Wandlitzschwein	Wandlitz|Schwein
Wappenkönig	Wappen|König
Warmbluthengst	Warmblut|Hengst
Warzenschwein	Warze|Schwein
Wassergott	Wasser|Gott
Wasserguru	Wasser|Guru
Waßkönig	Waß|König
Waveikone	Wave|Ikone
Wechselwirkungsgott	Wechselwirkung|Gott
Weibergott	Weib|Gott
Weiberhengst	Weib|Hengst
Weidehengst	Weide|Hengst
Weiheikone	weihen|Ikone
Weihnachtsgott	Weihnacht|Gott
Weihnachtsikone	Weihnacht|Ikone
Weingott	Wein|Gott
Weinguru	Wein|Guru
Weinhengst	Wein|Hengst
Weisheitsgott	Weisheit|Gott
Weißweinguru	Weißwein|Guru
Wellnessapostel	Wellness|Apostel
Welsh-Ponyhengst	Welshpony|Hengst
Weltmusikikone	Weltmusik|Ikone
Weltraumdreck	Weltraum|Dreck
Weltuntergangsapostel	Weltuntergang|Apostel
Weltuntergangsguru	Weltuntergang|Guru
Werbeguru	werben|Guru
Werbekönig	werben|König
Werkzeugikone	Werkzeug|Ikone
Westgotenkönig	Westgote|König
Westküstenikone	Westküste|Ikone
Westschweine	West|Schwein
Wettbewerbsapostel	Wettbewerb|Apostel
Wetterapostel	Wetter|Apostel
Wettergott	Wetter|Gott
Wetterguru	Wetter|Guru
Wettkönig	wetten|König
Widerstandsikone	Widerstand|Ikone
Wikingergott	Wikinger|Gott
Wikingerkönig	Wikinger|König
Wildhengst	Wild|Hengst
Wildpferdhengst	Wildpferd|Hengst
Wildschwein	Wildschwein
Winterdreck	Winterdreck
Winterkönig	Winterkönig
Wirtschaftsguru	Wirtschaft|Guru
Wirtschaftsikone	Wirtschaft|Ikone
Wissensguru	Wissen|Guru
Witzbolzen	Witz|Bolzen
Wohnungsschweine	Wohnung|Schwein
Wollmilchschweine	Wollmilch|Schwein
Wollschweins	Wolle|Schwein
Wordspielschwein	Wordspiel|Schwein
Wortdreck	Wort|Dreck
Wrestlingikone	Wrestling|Ikone
Wunderapostel	Wunder|Apostel
Wundergott	Wunder|Gott
Wunderhengst	Wunder|Hengst
Wunderschwein	Wunder|Schwein
Wurzelguru	Wurzel|Guru
Wüstendreck	Wüste|Dreck
Wüstenikone	Wüste|Ikone
Yorkshire-Schwein	Yorkshire|Schwein
Yuppidreck	Yuppi|Dreck
Zapfenschwein	Zapfen|Schwein
Zarenikone	Zar|Ikone
Zauberkönig	Zauber|König
Zaunkönig	Zaun|König
Zebrahengst	Zebra|Hengst
Zeckendreck	Zecke|Dreck
Zeckenschwein	Zecke|Schwein
Zeigefingergott	Zeigefinger|Gott
Zeitgeistapostel	Zeitgeist|Apostel
Zeitikone	Zeit|Ikone
Zentralikone	zentral|Ikone
zickengott	Zicke|Gott
Ziegengott	Ziege|Gott
Ziegenschweinen	Ziege|Schwein
Zirkusdreck	Zirkus|Dreck
Zirkusschwein	Zirkus|Schwein
Zivilisationsdreck	Zivilisation|Dreck
Züchterschweine	Züchter|Schwein
Zuchthengst	Zucht|Hengst
Zukunftsapostel	Zukunft|Apostel
Zukunftshengst	Zukunft|Hengst
Zündbolzen	zünden|Bolzen
Zweitgott	zweit|Gott
Zwergenkönig	Zwerg|König
Zwergenschwein	Zwerg|Schwein
